[CLS] proof why [MASK] are smarter than cats ? [SEP]	dogs	Q144	intelligence
[CLS] what is cleaner ? [MASK] or ham ##ster ? [SEP]	Gerbil	Q244770	clean
[CLS] does a [MASK] or dog cost more ? [SEP]	cat	Q146	price
[CLS] why are [MASK] mouths cleaner that humans ? [SEP]	dogs	Q144	clean
[CLS] are [MASK] mouths cleaner than humans ? ? ? ? [SEP]	monkeys	Q1367	clean
[CLS] in runes ##cape are sword ##fish more popular than [MASK] [SEP]	lobsters	Q1038113	other
[CLS] is it true that a [MASK] mouth is ten times cleaner than a human ' s ? and if it is , how come ? [SEP]	dog's	Q144	clean
[CLS] are ham ##sters cute ##r than [MASK] [SEP]	rats	Q36396	cute
[CLS] are kitten ##s ' temperatures usually higher than that of adult [MASK] [SEP]	cats	Q146	height
[CLS] which animal is faster , a rabbit or a [MASK] [SEP]	house cat	Q146	speed
[CLS] are pu ##gs more likely to have health complications then other [MASK] breeds ? [SEP]	dog	Q144	other
[CLS] are [MASK] cleaner than humans ? [SEP]	cockroaches	Q18123008	clean
[CLS] what pet is cheaper ? a rat or a [MASK] [SEP]	ferret	Q178973	price
[CLS] what is smarter a cat or a [MASK] in a sc ##ein ##ti ##fi ##c explanation ? [SEP]	dog	Q144	intelligence
[CLS] what is the di ##ff ##rence b / w an [MASK] and an indian elephant . which one is stronger ? [SEP]	african elephant	Q185038	strength
[CLS] do dog really have better hearing than h [MASK] [SEP]	umans?	Q15978631	hearing
[CLS] what has a harder bite force a wolf or a [MASK] [SEP]	coyote	Q44299	other
[CLS] which species is more intelligent , the cat or the [MASK] [SEP]	dog	Q144	intelligence
[CLS] is an [MASK] stronger than a chi ##mp ##an ##zee ? [SEP]	orangutan	Q41050	strength
[CLS] is adult male salt ##water crocodile bite force far more powerful and stronger than adult [MASK] bite ? [SEP]	great white shark	Q129026	strength
[CLS] what smells worse ? bunny or [MASK] 10 points ! ? [SEP]	ferret	Q178973	smelly
[CLS] are [MASK] generally stronger than humans or humans stronger ? [SEP]	dogs	Q144	strength
[CLS] which one would be better [MASK] or mar ##mos ##et ? [SEP]	Fox	Q8331	other
[CLS] who is smarter , [MASK] or cats ? [SEP]	Dogs	Q144	intelligence
[CLS] is a [MASK] heavier than a sea ##gul ##l if they were both the same size ? [SEP]	pigeon	Q10856	mass
[CLS] who can run faster a [MASK] or a cat ? [SEP]	dog	Q144	speed
[CLS] what has better looking legs , a sea ##gul ##l or a [MASK] ? ? [SEP]	chicken	Q780	other
[CLS] which one is cute ##r [MASK] or cats ? [SEP]	dogs	Q144	cute
[CLS] what is better border col ##lie , border col ##lie [MASK] mix , or border col ##lie re ##tre ##ver mix ? [SEP]	lab	Q38726	other
[CLS] why do scratches from kitten ##s / [MASK] hurt longer than other scratches ? [SEP]	cats	Q146	length
[CLS] what ##s better [MASK] or wolves ? [SEP]	foxes	Q8331	other
[CLS] which is better : a squirrel or a [MASK] [SEP]	rabbit	Q9394	other
[CLS] what breed of dog is better an [MASK] or english set ##ter ? [SEP]	English Pointer	Q769804	other
[CLS] which type of [MASK] is better ( which is easier handled , etc . ) , a rob ##oro ##vs ##ki or a syrian ( golden ) ham ##ster ? [SEP]	hamster	Q204175	other
[CLS] what is cute ##r a . . . . [MASK] or ham ##ster ! ! ! ! ! ! ! ? [SEP]	GUINEA PIG	Q79803	cute
[CLS] what is better , lizard or [MASK] and why ? [SEP]	snake	Q2102	other
[CLS] how much longer is a [MASK] int ##est ##ine than a humans ? [SEP]	blue whale	Q42196	length
[CLS] what is stronger , a silver ##back gorilla or a [MASK] [SEP]	polar bear	Q33609	strength
[CLS] poll : which one is cute ##r ? my cat or my [MASK] [SEP]	Dog	Q144	cute
[CLS] is a [MASK] stronger , or a chi ##mp ? [SEP]	chimp	Q4126704	strength
[CLS] why ham ##ster is cleaner than [MASK] why it ' s not hara ##m ? [SEP]	dogs	Q144	clean
[CLS] are [MASK] as a gr ##ope more closely related to wolves ? [SEP]	spitz	Q854787	other
[CLS] which pet is more expensive to take care of , a small dog or a [MASK] [SEP]	cat	Q146	price
[CLS] why is the [MASK] more endangered than the white rhino ? [SEP]	black rhino	Q95036	endangered
[CLS] why do elephants live longer than [MASK] [SEP]	humans	Q15978631	lifespan
[CLS] physiological ##ly : why are [MASK] so much stronger than humans ? [SEP]	apes	Q102470	strength
[CLS] do [MASK] make better pets than lizards . my ld bea ##ded dragon sucked did i just have bad luck or what ? [SEP]	snakes	Q2102	other
[CLS] which is cute ##r ? full grown [MASK] or baby yellow chickens ? [SEP]	Ducks	Q3736439	cute
[CLS] which is smarter [MASK] or a fish smarter ? [SEP]	hamster	Q6573	intelligence
[CLS] how much stronger are chi ##mp ##an ##zee ' s than [MASK] s ? are they stronger than ever human male body ##bu ##ilde ##rs ? [SEP]	Chimpanzee	Q4126704	strength
[CLS] is our [MASK] mouth still cleaner than humans after what she did ? [SEP]	dog's	Q144	clean
[CLS] why are [MASK] more stronger and agile than us humans ? [SEP]	chimpanzees	Q4126704	strength
[CLS] do dwarf ham ##sters smell worse than [MASK] [SEP]	fish	Q152	smelly
[CLS] are cats smarter than [MASK] [SEP]	dogs	Q144	intelligence
[CLS] true or false : dogs are more dangerous than [MASK] [SEP]	cats	Q146	dangerous
[CLS] which is cheaper , a guinea pig or a [MASK] [SEP]	hamster	Q6573	price
[CLS] are [MASK] a bigger breed of pu ##g ? [SEP]	english mastiffs	Q38418	other
[CLS] what is more dangerous - - [MASK] or alligator ? [SEP]	crocodile	Q2535664	dangerous
[CLS] [MASK] or fe ##rret ##s , which is cute ##r ? [SEP]	Guinea pigs	Q79803	cute
[CLS] which is taller at the shoulder , african lion or [MASK] [SEP]	Siberian tiger	Q69581	height
[CLS] cats versus [MASK] smarter ? [SEP]	dogs	Q144	intelligence
[CLS] which animal is a better hunter a wolf or a [MASK] and why ? [SEP]	tiger	Q19939	other
[CLS] which are more intelligent cats or [MASK] [SEP]	dogs	Q144	intelligence
[CLS] how fast can an ali ##gat ##or run ? can they run faster than [MASK] [SEP]	humans	Q15978631	speed
[CLS] poll : which is cute ##r , sleeping [MASK] or sleeping cats ? [SEP]	dogs	Q144	cute
[CLS] cute ##r : baby , puppy , or [MASK] [SEP]	Kitten	Q147	cute
[CLS] what is more expensive keeping a fish tank or a an ##ole [MASK] [SEP]	anole	Q930252	price
[CLS] what smells worse : dead [MASK] or dog po ##op ? [SEP]	fish	Q152	smelly
[CLS] is a [MASK] mouth cleaner than a human ' s ? [SEP]	dog's	Q144	clean
[CLS] why can a canadian dog get a ct scan or mri faster than a [MASK] [SEP]	human	Q15978631	speed
[CLS] which do you think is cute ##r . . . pup ##pies or [MASK] [SEP]	kittens	Q147	cute
[CLS] what are the most recent [MASK] discovered that are bigger than a t - rex and are car ##ni ##vor ##es ? [SEP]	dinosaurs	Q430	other
[CLS] are dogs faster than [MASK] [SEP]	mice	Q2751034	speed
[CLS] which is more intelligent , a house ##fly or a [MASK] [SEP]	German Cockroach	Q466194	intelligence
[CLS] are [MASK] mouths really cleaner than humans ? if so how ? [SEP]	dogs	Q144	clean
[CLS] pu ##g v / s [MASK] which is better for apartment life ? [SEP]	whippet	Q39122	other
[CLS] are chow ##s mean ##er than [MASK] cause a chow bit me yesterday ? ? ? ! ! ! ! ? [SEP]	chows	Q29013	mean
[CLS] is a german shepherd smarter then a [MASK] [SEP]	boxer	Q38496	intelligence
[CLS] which are worse , pit bulls or [MASK] http : / / www . cdc . gov / nc ##ip ##c / du ##ip / dog ##bre ##ed ##s . . . . ? [SEP]	Rottweilers	Q39093	other
[CLS] is she more wolf or [MASK] [SEP]	dog	Q144	other
[CLS] what smells worse : [MASK] or ham ##sters ? i also have some questions . 10 pts best answer ? [SEP]	Chinchillas	Q192930	smelly
[CLS] who is cute ##r ? ? ? [MASK] or kitten ##s ? [SEP]	kittens	Q147	cute
[CLS] why are wasps so much mean ##er than [MASK] [SEP]	bees	Q7391	mean
[CLS] which one is cute ##r a cho ##lot ##e lab or a [MASK] [SEP]	boxer	Q38496	cute
[CLS] which is cute ##r - [MASK] or pup ##pies ? [SEP]	kittens	Q147	cute
[CLS] are cats more intelligent than [MASK] [SEP]	dogs	Q144	intelligence
[CLS] is a kurdish kang ##al stronger or a [MASK] and wi ##ch one is more loyal ? ? ? [SEP]	german shepherd	Q38280	strength
[CLS] what type of dog is cheaper and easier to care for ? maltese or [MASK] ( = ? [SEP]	Yorkie	Q39330	price
[CLS] is a ge ##rb ##il larger than a [MASK] [SEP]	chipmunk	Q85752125	size
[CLS] will dogs live longer like [MASK] [SEP]	humans	Q15978631	lifespan
[CLS] who is smarter cat or [MASK] [SEP]	dog	Q144	intelligence
[CLS] are [MASK] more affection ##ate & playful than rabbits ? do they chew less too ? [SEP]	guinea pigs	Q79803	friendliness
[CLS] do dog far ##ts really smell much worse than [MASK] far ##ts ? what do they smell like ? [SEP]	human	Q15978631	smelly
[CLS] which spider is more poisonous ? the black widow or the [MASK] [SEP]	brown recluse	Q284352	venomous
[CLS] is a cornered fox really more dangerous than a [MASK] [SEP]	jackal	Q125525	dangerous
[CLS] is it true that cat is smarter than [MASK] [SEP]	dog	Q144	intelligence
[CLS] which dog is more train ##able pit ##bu ##lls or [MASK] s ? [SEP]	chihuahua	Q653	other
[CLS] would you consider yourself to be more like a noble [MASK] or rather a low ##ly weasel ? [SEP]	eagle	Q2092297	other
[CLS] will [MASK] live longer like humans ? [SEP]	dogs	Q144	lifespan
[CLS] don ##t you think wolves look more cute than [MASK] for home security ? [SEP]	dogs	Q144	other
[CLS] r & s poll : which is cute ##r ? baby elephants or baby [MASK] [SEP]	Giraffes	Q862089	cute
[CLS] which would be cooler a pet [MASK] or a pet squirrel ? [SEP]	monkey	Q1367	other
[CLS] poll : which are cute ##r : pup ##pies or [MASK] [SEP]	Kitties	Q147	cute
[CLS] do dogs live longer than [MASK] [SEP]	humans	Q15978631	lifespan
[CLS] which are smarter , cats or [MASK] [SEP]	dogs	Q144	intelligence
[CLS] is male am ##ur tiger more powerful or stronger than male [MASK] [SEP]	african lion	Q140	strength
[CLS] poll ~ cats or [MASK] which is cute ##r ? [SEP]	Dogs	Q144	cute
[CLS] are [MASK] smarter than other fish ? [SEP]	goldfish	Q123141	intelligence
[CLS] do ham ##sters smell bad ? ( worse than [MASK] , i ' m trying to adopt one but my mom thinks they are evil . ? [SEP]	gerbils	Q244770	smelly
[CLS] whose mouth is cleaner a [MASK] or a cat ? [SEP]	dog	Q144	clean
[CLS] do birds hear better than [MASK] [SEP]	humans	Q15978631	hearing
[CLS] which runs faster , a ham ##ster or a [MASK] [SEP]	mouse	Q2751034	speed
[CLS] which is more po ##ision ##ous wall lizard or [MASK] [SEP]	snake	Q2102	other
[CLS] do house cats behave the same way as large cats ( like [MASK] , but on a smaller scale ? [SEP]	lions	Q140	other
[CLS] which ham ##ster is friend ##lier , chinese or [MASK] [SEP]	russian dwarf hamster	Q214633	friendliness
[CLS] which pet is cheaper ? chinese water dragon or snow ##fl ##ake eel ? [SEP]	Eel	Q128685	price
[CLS] what ##s better to own [MASK] or pu ##g ? [SEP]	husky	Q39295	other
[CLS] which would be easier for a begin ##ner to raise , bet ##tas or [MASK] [SEP]	goldfish	Q123141	other
[CLS] [MASK] and whales , did you know , are more intelligent than us in all areas of knowledge and spirituality ? [SEP]	Dolphins	Q7369	intelligence
[CLS] which is cute ##r a polar bear or a [MASK] [SEP]	penguin	Q9147	cute
[CLS] why are chi ##mp ##an ##zee ##s stronger than [MASK] [SEP]	Chimpanzees	Q4126704	strength
[CLS] which are cute ##r : huskies or [MASK] [SEP]	BEAGLES	Q21102	cute
[CLS] why human are way weaker than an [MASK] ? [SEP]	Ants	Q7386	strength
[CLS] are [MASK] more friendly than squirrels ? how are they different than squirrels ? [SEP]	chip monks	Q85752125	other
[CLS] who is smarter ' a chicken or a [MASK] ? [SEP]	duck	Q3736439	intelligence
[CLS] what should i get better , a dwarf ham ##ster or a [MASK] [SEP]	russian tortoise	Q754182	other
[CLS] which are more beautiful : [MASK] or black swans ? [SEP]	white swans	Q25402	other
[CLS] poll : are cats or [MASK] smarter ? [SEP]	dogs	Q144	intelligence
[CLS] what is a better pet a lizard or [MASK] [SEP]	turtle	Q223044	other
[CLS] are [MASK] smarter than guinea pigs ? [SEP]	Cockatiels	Q514809	intelligence
[CLS] which is cute ##r ? - pup ##pies or [MASK] [SEP]	kittens	Q147	cute
[CLS] which is cute ##r , kitten ##s or [MASK] [SEP]	kittens	Q147	cute
[CLS] between [MASK] and a small lizard , which is better for college ? [SEP]	fish	Q152	other
[CLS] can [MASK] hear better than humans ? [SEP]	elephants	Q7378	hearing
[CLS] poll : which is cute ##r ? [MASK] or pup ##pies ? [SEP]	kittens	Q147	cute
[CLS] is a [MASK] mouth cleaner than a humans ? [SEP]	dogs	Q144	clean
[CLS] why are most people more scared of roach ##es than [MASK] [SEP]	ants	Q7386	dangerous
[CLS] is it true that [MASK] mouths are cleaner then humans ? [SEP]	dogs	Q144	clean
[CLS] is it true that a hip ##po can run faster than a [MASK] [SEP]	human being	Q15978631	speed
[CLS] if the mom who is a po ##odle 14 pounds how much will the [MASK] weigh full grown ? will the puppy weigh less or mor ? [SEP]	poodle	Q38904	mass
[CLS] what is a better pet a [MASK] or a pu ##g ? [SEP]	chow chow	Q29013	other
[CLS] are pit bulls bred for fighting , is that why they attack people more than other big [MASK] [SEP]	dogs	Q144	other
[CLS] which swim ##s faster dogs or [MASK] [SEP]	cats	Q146	swimmingspeed
[CLS] which is more dangerous a [MASK] or an alligator ? [SEP]	crocodile	Q2535664	dangerous
[CLS] is there any fish more ag ##gre ##sive ( eater ) then the black pi ##ran ##ha ? [SEP]	black piranha	Q2038575	dangerous
[CLS] what ' s cute ##r ? - [MASK] kitten ##s or babies ? [SEP]	kittens	Q147	cute
[CLS] which is cute ##r [MASK] or kitten ##s ? [SEP]	kittens	Q147	cute
[CLS] is a [MASK] smarter than a coyote ? [SEP]	Wolf	Q18498	intelligence
[CLS] what ' s cute ##r : babies , pup ##pies , or [MASK] ? [SEP]	Kitties	Q147	cute
[CLS] [MASK] vs lizards ? ? ? which ones better ? [SEP]	Snakes	Q2102	other
[CLS] why do dogs and other animals age so much faster than [MASK] ? [SEP]	humans	Q15978631	lifespan
[CLS] poll : which are cute ##r ; [MASK] or kitten ##s ? [SEP]	kittens	Q147	cute
[CLS] what is more expensive to take care of [MASK] or chinese crested ? [SEP]	Pomeranian	Q39579	price
[CLS] which spider venom is worse a black widow or a [MASK] [SEP]	Brown Recluse	Q284352	other
[CLS] which is cute ##r , a [MASK] or a kitten ? [SEP]	puppy	Q39266	cute
[CLS] why is [MASK] cheaper than red salmon ? [SEP]	Pink Salmon	Q673380	price
[CLS] ~ who is cute ##r : [MASK] or dolphin . . . . . . . . . . . ? [SEP]	penguin	Q9147	cute
[CLS] is [MASK] cleaner , less no ##isi ##er and cute ##r than ham ##sters or ham ##sters ? [SEP]	gerbils	Q244770	clean
[CLS] is a [MASK] or rabbit smarter ! ? [SEP]	guinea pig	Q79803	intelligence
[CLS] why sword ##fish contain more mercury than [MASK] [SEP]	trout	Q2258881	other
[CLS] are [MASK] smarter than cats ? [SEP]	dogs	Q144	intelligence
[CLS] are [MASK] cute ##r than cats ? [SEP]	dogs	Q144	cute
[CLS] which dog is smarter [MASK] or ha ##van ##ese ? [SEP]	beagle	Q21102	intelligence
[CLS] who can run faster a cat or a [MASK] [SEP]	dog	Q144	speed
[CLS] poll : which is worse : moths or [MASK] [SEP]	Spiders	Q1357	other
[CLS] what is more expensive : an [MASK] or a siberian husky ? [SEP]	Alaskan Malamute	Q21206	price
[CLS] do [MASK] or ham ##sters smell worse ? [SEP]	guinea pigs	Q79803	smelly
[CLS] which is cute ##r , a husky or a [MASK] [SEP]	beagle	Q21102	cute
[CLS] are [MASK] more prone to biting people than pit ##bu ##lls ? [SEP]	german shepherds	Q38280	other
[CLS] is a [MASK] stronger , or a chi ##mp ? [SEP]	lion	Q140	strength
[CLS] which is smarter in your opinion ? cats or [MASK] [SEP]	Dogs	Q144	intelligence
[CLS] what is bigger : a gi ##raf ##fe or an [MASK] [SEP]	elephant	Q7378	size
[CLS] are [MASK] cheaper than dogs ? [SEP]	cats	Q146	price
[CLS] what breed of [MASK] or lizard it better to have ? [SEP]	snake	Q2102	other
[CLS] which dog is smarter bea ##gle or [MASK] [SEP]	beagle	Q21102	intelligence
[CLS] is breeding [MASK] easier or harder than breeding bet ##tas ? [SEP]	gourami	Q726399	other
[CLS] why is it cheaper to use [MASK] in an experiment rather than humans ? [SEP]	sheep	Q7368	price
[CLS] are sharks smarter than [MASK] [SEP]	goldfish	Q123141	intelligence
[CLS] why are flies faster than [MASK] [SEP]	humans	Q15978631	speed
[CLS] which animal is better and why ? wolf or [MASK] [SEP]	Bear	Q11788	other
[CLS] which is cute ##r , [MASK] or pup ##pies ? [SEP]	kittens	Q147	cute
[CLS] which is smarter [MASK] or chickens ? if each were to play check ##ers ag ##ians ##t each other who would win ? [SEP]	dinosaurs	Q430	intelligence
[CLS] do pu ##gs shed more than [MASK] [SEP]	golden retrievers	Q38686	other
[CLS] whose mouth is cleaner a turtles , or a [MASK] [SEP]	frogs	Q53636	clean
[CLS] why do [MASK] live longer than humans ? [SEP]	turtles	Q223044	lifespan
[CLS] which is smarter a [MASK] or a seal ? [SEP]	dolphin	Q7369	intelligence
[CLS] which is taller : a [MASK] or a golden retrieve ##r ? [SEP]	labrador retriever	Q38726	height
[CLS] which is cute ##r pup ##pies or [MASK] [SEP]	kittens	Q147	cute
[CLS] do little dogs get dirty faster than big dogs any all natural [MASK] protector ##s . can a dog be nuts ? [SEP]	flea	Q388162	speed
[CLS] which is cute ##r monkey or a [MASK] [SEP]	frog	Q53636	cute
[CLS] are [MASK] smarter than cats ? [SEP]	rats	Q36396	intelligence
[CLS] which are cute ##r : cats or [MASK] [SEP]	dogs	Q144	cute
[CLS] which is smarter a [MASK] or a cat or both ? [SEP]	dog	Q144	intelligence
[CLS] which is smarter ; a cat or a [MASK] [SEP]	dog	Q144	intelligence
[CLS] who is smarter a cat or a [MASK] [SEP]	dog	Q144	intelligence
[CLS] cats are smarter than [MASK] because they are independent ? [SEP]	dogs	Q144	intelligence
[CLS] are beta fish better than [MASK] to keep as pets ? [SEP]	goldfish	Q123141	other
[CLS] whose mouth is cleaner : human mouth or [MASK] mouth ? [SEP]	cat	Q146	clean
[CLS] why do dogs far ##ts smell worse than [MASK] [SEP]	humans	Q15978631	smelly
[CLS] which is cute ##r ? [MASK] or puppy ? [SEP]	Kitten	Q147	cute
[CLS] what would go better with my male bet ##ta ? a male or female sucker ##fish ? [SEP]	Suckerfish	Q1156517	other
[CLS] does the whale live longer than the [MASK] [SEP]	turtle	Q223044	length
[CLS] are [MASK] more poisonous than normal false black widows ? [SEP]	false black widows	Q1409317	venomous
[CLS] what is more dangerous to people - a lynx or a [MASK] [SEP]	cheetah	Q23907	dangerous
[CLS] what is a cat ' s reaction time ? is it faster then a [MASK] s ( about 1 / 4 second ) ? [SEP]	human	Q15978631	speed
[CLS] are [MASK] smarter than cats or vis ##e versa ? [SEP]	dogs	Q144	intelligence
[CLS] is [MASK] life cheaper than that of dogs ? [SEP]	human	Q15978631	price
[CLS] what is cleaner : a [MASK] mouth or a humans ? [SEP]	dog's	Q144	clean
[CLS] are [MASK] more ag ##gre ##sive than dogs ? [SEP]	cats	Q146	dangerous
[CLS] between lizard and [MASK] which have longer tongue ? [SEP]	frog	Q53636	other
[CLS] which are smarter , [MASK] or rabbits ? [SEP]	rats	Q36396	intelligence
[CLS] which has a cleaner mouth a [MASK] or dog ? [SEP]	camel	Q7375	smelly
[CLS] which pet would cost more : a [MASK] or two fe ##rret ##s ? * help please ! ! ! * ? [SEP]	kitten	Q147	price
[CLS] [MASK] or dolphin which is cute ##r ? [SEP]	Penguin	Q9147	cute
[CLS] who ' s tough ##er a [MASK] or a pit ##bu ##ll ? [SEP]	boxer	Q38496	other
[CLS] whose mouth is cleaner : [MASK] mouth or cat mouth ? [SEP]	human	Q15978631	clean
[CLS] pitt ##bu ##ll vs . [MASK] which makes a better pet , and why ? [SEP]	Rottweiler	Q39093	other
[CLS] is a [MASK] stronger then a do ##berman ? [SEP]	chow chow	Q29013	strength
[CLS] what is more intelligent - a [MASK] or a killer whale ? [SEP]	tiger	Q19939	intelligence
[CLS] which is faster . whip ##pet or [MASK] [SEP]	Greyhound	Q38571	speed
[CLS] which is smarter to you , cats or [MASK] [SEP]	dogs	Q144	intelligence
[CLS] why is lobster more expensive than [MASK] [SEP]	crab	Q40802	price
[CLS] which fish can you get cheaper supplies for : bet ##ta or [MASK] [SEP]	goldfish	Q123141	other
[CLS] is a guinea pig or [MASK] smarter ! ? [SEP]	rabbit	Q9394	intelligence
[CLS] how do dogs have cleaner mouths than [MASK] [SEP]	humans	Q15978631	smelly
[CLS] why are chi ##mp ##an ##zee ##s more stronger and agile than us [MASK] [SEP]	chimpanzees	Q4126704	strength
[CLS] which are cute ##r : [MASK] or kitten ##s ? [SEP]	kittens	Q147	cute
[CLS] which pet is easier to train a [MASK] or a pit bull ? [SEP]	rottweiler	Q39093	other
[CLS] is cat saliva cleaner than [MASK] [SEP]	humans	Q15978631	clean
[CLS] true or false : you are more scared of cock ##ro ##ache ##s than house [MASK] ? [SEP]	spiders	Q1357	dangerous
[CLS] ultimate poll question # 1 which is cute ##r . . pup ##pies or [MASK] . . go ! ? [SEP]	Kittens	Q147	cute
[CLS] why does a [MASK] looking for food use up ##to thirty times more energy than a lizard of the same weight ? [SEP]	mouse	Q2751034	other
[CLS] is it true that [MASK] mouths are cleaner then humans and is it true that the dogs spit can cure a disease ? [SEP]	humans	Q15978631	clean
[CLS] who is smarter ? a [MASK] or a cat ? [SEP]	dog	Q144	intelligence
[CLS] why [MASK] are so stronger than humans ? [SEP]	chimps	Q4126704	strength
[CLS] why are [MASK] stronger than humans ? [SEP]	Chimpanzees	Q4126704	strength
[CLS] which one is cute ##r : baby [MASK] or baby human ? ( pic ##s ) ? [SEP]	bunny	Q9394	cute
[CLS] is a [MASK] pit bull less likely to attack vs . a mixed breed pit bull ? [SEP]	purebred	Q39120	other
[CLS] poll : what ##s cute ##r [MASK] or puppy ##s ? [SEP]	kittens	Q147	cute
[CLS] are [MASK] typically smarter than cats ? [SEP]	dogs	Q144	intelligence
[CLS] why do you think [MASK] are more popular than other fish ? [SEP]	Bettas	Q4164940	other
[CLS] pu ##g or a [MASK] which one do u think is cute ##r ? [SEP]	french bulldog	Q29149	other
[CLS] what is more intelligent a cat or a [MASK] [SEP]	dog	Q144	intelligence
[CLS] what smells worse - [MASK] or dog far ##ts ? [SEP]	human	Q15978631	smelly
[CLS] why do [MASK] live longer then dogs ? [SEP]	cats	Q146	length
[CLS] are guinea pigs more affection ##ate & playful than [MASK] do they chew less too ? [SEP]	rabbits	Q9394	friendliness
[CLS] how much stronger are [MASK] as compared to humans ? [SEP]	gorillas	Q36611	strength
[CLS] why are [MASK] so much more expensive than bengal cats ? [SEP]	Savannahs	Q42670	price
[CLS] why is the rabbit smarter than the [MASK] [SEP]	bear	Q11788	intelligence
[CLS] which spiders bite is more poisonous the [MASK] or a camel spider ? [SEP]	Brown Recluse	Q284352	venomous
[CLS] which is faster , three - legged [MASK] or lightweight hip ##pop ##ota ##mus ? [SEP]	cheetah	Q23907	speed
[CLS] why is wild caught sock ##eye salmon more expensive than wild caught [MASK] [SEP]	coho salmon	Q934874	price
[CLS] which fish is smarter ? [MASK] or black moore ? [SEP]	goldfish	Q123141	intelligence
[CLS] what ##s cooler tiger or wolf , then [MASK] or the winner of that ? [SEP]	white tiger	Q643213	other
[CLS] what is heavier a 16 foot [MASK] or a 14 foot great white shark ? [SEP]	saltwater crocodile	Q182599	mass
[CLS] [MASK] vs . turtle which is faster ? [SEP]	Sloth	Q2274076	speed
[CLS] r female [MASK] more aggressive than males . iv ##e got a blue pit ##bu ##ll . 4 months old ? [SEP]	dogs	Q144	other
[CLS] why is [MASK] more expensive than crab ? [SEP]	lobster	Q1038113	price
[CLS] who ' s stronger pit ##bu ##ll or [MASK] [SEP]	american bulldog	Q37604	other
[CLS] which is better ? wolves or [MASK] [SEP]	foxes	Q8331	other
[CLS] which is cute ##r kitten ##s or [MASK] [SEP]	kittens	Q147	cute
[CLS] why do [MASK] live longer than humans ? [SEP]	parrots	Q31431	lifespan
[CLS] [MASK] are al ##ot stronger than humans . . . ? [SEP]	Chimpanzees	Q4126704	strength
[CLS] which is more powerful : a pack of [MASK] or a gr ##izzly bear ? [SEP]	wolves	Q18498	strength
[CLS] how are [MASK] dirt ##ier than chickens ? [SEP]	pigs	Q787	clean
[CLS] [MASK] mouth cleaner than a humans ? [SEP]	Dogs	Q144	clean
[CLS] why are savannah ##s so much more expensive than [MASK] [SEP]	Bengal cats	Q42583	price
[CLS] which one is mean ##er a ham ##ster or a [MASK] [SEP]	guinea pig	Q79803	mean
[CLS] why are [MASK] so much stronger than humans ? [SEP]	gorillas	Q36611	strength
[CLS] why do [MASK] live longer than dogs ? [SEP]	humans	Q15978631	lifespan
[CLS] is it cheaper to own a [MASK] or dog ? [SEP]	cat	Q146	price
[CLS] what are cute ##r , chin ##chi ##llas or [MASK] [SEP]	Chinchillas	Q192930	cute
[CLS] what ##s worse , wolves or [MASK] [SEP]	Coyotes	Q44299	other
[CLS] are [MASK] more dangerous then dogs ? [SEP]	Cats	Q146	dangerous
[CLS] r cats or [MASK] cute ##r ? [SEP]	dogs	Q144	cute
[CLS] which [MASK] is stronger an american ai ##kt ##a or a gray wolf ? [SEP]	dog	Q144	other
[CLS] which is a faster runner , a [MASK] or a wolf ? [SEP]	coyote	Q44299	other
[CLS] poll [MASK] runs faster than cat yes or no ? [SEP]	rat	Q36396	speed
[CLS] what is smarter a mac ##aw or a [MASK] [SEP]	cockatoo	Q31448	intelligence
[CLS] which animal is cute ##r ? cat or [MASK] [SEP]	rabbit	Q9394	cute
[CLS] what are better house pets , [MASK] or pit ##bu ##lls ? [SEP]	siberian huskies	Q39295	other
[CLS] witch is more trust worthy ? [MASK] or pit ##bu ##ll ? [SEP]	Rottweiler	Q39093	other
[CLS] which are smarter [MASK] or cats ? [SEP]	dogs	Q144	intelligence
[CLS] do gold ##fish live longer than other [MASK] [SEP]	goldfish	Q123141	lifespan
[CLS] was mammoth ##s really bigger than the biggest [MASK] species today ? [SEP]	elephant	Q185038	size
[CLS] do [MASK] fly higher than flies ? [SEP]	bees	Q102857	height
[CLS] what is smarter , a [MASK] or a rabbit ? [SEP]	hamster	Q6573	intelligence
[CLS] what is faster a [MASK] or a cat ? [SEP]	rabbit	Q9394	speed
[CLS] poll : which are cute ##r pup ##pies or [MASK] [SEP]	kittens	Q147	cute
[CLS] which one is better to get a [MASK] or a dwarf ham ##ster ? [SEP]	guinea pig	Q79803	other
[CLS] how are pigs dirt ##ier than [MASK] [SEP]	chickens	Q780	clean
[CLS] which is more intelligent cats or [MASK] [SEP]	dogs	Q144	intelligence
[CLS] are [MASK] stronger than most world stronger man competitors ? [SEP]	chimpanzees	Q4126704	strength
[CLS] are wolves better at smelling than [MASK] [SEP]	tigers	Q19939	other
[CLS] are [MASK] more friendly than chinese ham ##sters ? [SEP]	Russian hamsters	Q214633	other
[CLS] are pit bulls or [MASK] better ? [SEP]	huskies	Q39295	other
[CLS] why are there fewer [MASK] than gaze ##lles in the african sava ##nah ? [SEP]	lions	Q140	other
[CLS] why are people so much more afraid of [MASK] than other rodents ? [SEP]	rats	Q36396	dangerous
[CLS] what pet is better , a beta fish or a [MASK] [SEP]	Hamster	Q6573	other
[CLS] who is cute ##r ? ? ? pup ##pies or [MASK] [SEP]	kittens	Q147	cute
[CLS] [MASK] and bet ##ta questions , or more like why would you even want one ? [SEP]	Gold fish	Q123141	other
[CLS] are [MASK] more intelligent than cats ? why or why not ? [SEP]	mice	Q2751034	intelligence
[CLS] what ' s cute ##r , squirrels or [MASK] [SEP]	bunnies	Q9394	cute
[CLS] what are cute ##r , [MASK] or ham ##sters ? [SEP]	Chinchillas	Q192930	cute
[CLS] how are [MASK] better adapted than wolves ? pl ##z help ! ? [SEP]	coyotes	Q44299	other
[CLS] what is mean ##er a [MASK] or a wolverine ? [SEP]	badger	Q638105	mean
[CLS] are [MASK] more high - energy than border col ##lies ? [SEP]	chihuahuas	Q653	other
[CLS] what is more scary two [MASK] or two wolves ? [SEP]	rottweilers	Q39093	other
[CLS] which animals are cleaner , [MASK] or cats ? which & why ? when i say cleaner , which smell less ? why ? [SEP]	rabbits	Q9394	clean
[CLS] which is better : a [MASK] or a rob ##o ham ##ster ? [SEP]	winter white hamster	Q214633	other
[CLS] what is more expensive , [MASK] or guinea pigs ? ( in philippines ? ) ? [SEP]	Hamsters	Q6573	price
[CLS] are you more afraid of cock ##ro ##ache ##s or [MASK] [SEP]	centipedes	Q43447	dangerous
[CLS] is it true a [MASK] mouth is cleaner than a humans ? ? [SEP]	dogs	Q144	clean
[CLS] which one is more expensive : hal ##ib ##ut or [MASK] [SEP]	salmon	Q2796766	price
[CLS] which is more poisonous black cobra or [MASK] [SEP]	Tarantula	Q213383	venomous
[CLS] might you be a liberal if deer and other non - [MASK] are smarter than you ? [SEP]	domesticated animals	Q25326504	intelligence
[CLS] what ##s more dangerous ? a bull moose or a bull [MASK] [SEP]	elk	Q180404	dangerous
[CLS] what smells worse a chin ##chi ##llas or [MASK] [SEP]	guinea pigs	Q79803	smelly
[CLS] what is better a [MASK] or a russian dwarf ham ##ster ? [SEP]	winter white hamster	Q214633	other
[CLS] who is more intelligent and affection ##ate a [MASK] or a rabbit ? [SEP]	rat	Q36396	intelligence
[CLS] which is cheaper : a [MASK] or a guinea pig ? [SEP]	rabbit	Q9394	price
[CLS] i want to buy a dog , do you think a pu ##g or a [MASK] is a better breed ? [SEP]	Pomeranian	Q39579	other
[CLS] are old english bulldog ##ges supposed to be more active than old english bulldogs ? [SEP]	English Bulldogges	Q38168	other
[CLS] what is generally a more sat ##is ##ying pet , a [MASK] or a lizard ? [SEP]	snake	Q2102	other
[CLS] why can ' t humans live longer than [MASK] . . ? [SEP]	sea turtles	Q219329	lifespan
[CLS] who ' s stronger ? a gorilla or an [MASK] [SEP]	ox	Q473194	strength
[CLS] do ge ##rb ##ils smell worse than [MASK] i also have some questions . best answer 10 pts ? [SEP]	gerbils	Q244770	smelly
[CLS] which are more efficient group hunters , [MASK] or wolves ? [SEP]	lions	Q140	other
[CLS] can a male bet ##ta that is bigger than my [MASK] live with them in peace ? [SEP]	tetras	Q13533436	other
[CLS] what ##s better a teddy [MASK] ham ##ster or dwarf ham ##ster ? [SEP]	bear	Q11788	other
[CLS] is a blue pit ##bu ##ll better then a white [MASK] [SEP]	pitbull	Q37612	other
[CLS] would a [MASK] or a lizard have a faster res ##piration rate ? [SEP]	mouse	Q2751034	other
[CLS] are male kitten ##s / [MASK] cute ##r or better looking than females ? [SEP]	cats	Q146	cute
[CLS] which are cute ##r : ham ##sters of [MASK] [SEP]	Bunnies	Q9394	cute
[CLS] who ' s smarter , cats or [MASK] [SEP]	dogs	Q144	intelligence
[CLS] is a [MASK] smarter than a chicken ? [SEP]	duck	Q3736439	intelligence
[CLS] are cat owners smarter than [MASK] owners ? [SEP]	dog	Q144	intelligence
[CLS] which do you like more [MASK] or wolves ? [SEP]	tigers	Q19939	other
[CLS] what is bigger , a [MASK] or a li ##ger ? [SEP]	siberian tiger	Q69581	size
[CLS] does os ##x [MASK] use more ram and such than snow leopard ? [SEP]	mountain lion	Q35255	other
[CLS] do male [MASK] urine smell worse than female fe ##line ' s urine ? [SEP]	cats	Q146	smelly
[CLS] why are all [MASK] far stronger than humans and yet are mostly vegetarian ? [SEP]	apes	Q102470	strength
[CLS] what ' s cute ##r [MASK] or ge ##rb ##il ? [SEP]	gerbil	Q244770	cute
[CLS] who can run faster a dog or a [MASK] [SEP]	cat	Q146	speed
[CLS] which is more intelligent , a rabbit or [MASK] [SEP]	guinea pig	Q79803	intelligence
[CLS] why is a dog ' s heart rate faster than a [MASK] s ? [SEP]	human	Q15978631	speed
[CLS] which is faster a cat or a [MASK] [SEP]	fox	Q8331	speed
[CLS] why do people think [MASK] was more dangerous than ty ##ran ##nos ##aurus rex ? [SEP]	spinosaurus	Q130966	other
[CLS] what animal is statistical ##ly smarter a rabbit or a [MASK] [SEP]	turtle	Q223044	intelligence
[CLS] which hears better a [MASK] or dog ? [SEP]	rabbit	Q9394	hearing
[CLS] rode ##nt invasion bigger than the average [MASK] . . ? [SEP]	house mouse	Q83310	size
[CLS] i need 10 reasons why pu ##gs are better than other [MASK] breeds . ? [SEP]	dog	Q144	other
[CLS] why do dogs age at a rate seven times faster than [MASK] [SEP]	humans	Q15978631	speed
[CLS] are [MASK] more intelligent than cats or vice versa ? [SEP]	dogs	Q144	intelligence
[CLS] how can [MASK] scare big cats when they are much more weak ? [SEP]	hunting dogs	Q38774	other
[CLS] poll : which is cute ##r , [MASK] kit ##ties , or babies ? [SEP]	kitties	Q147	cute
[CLS] are [MASK] or bet ##tas easier to care for ? [SEP]	guppies	Q178202	other
[CLS] was a [MASK] stronger than a modern silver ##back gorilla ? [SEP]	Gigantopithecus	Q310434	strength
[CLS] what ' s stronger a gr ##izzly bear or a [MASK] [SEP]	gorilla	Q36611	strength
[CLS] poll : which is cute ##r ? kitten ##s or [MASK] [SEP]	kittens	Q147	cute
[CLS] if humans could jump the way [MASK] do could we jump safely from the fifth floor of a building ? or higher ? [SEP]	cats	Q146	height
[CLS] [MASK] vs bet ##ta fish : which is a better pet ? [SEP]	Hamsters	Q6573	other
[CLS] which pet is dirt ##ier a cat or a [MASK] [SEP]	bird	Q5113	clean
[CLS] which are cute ##r , [MASK] or al ##pac ##as ? [SEP]	llamas	Q42569	cute
[CLS] are [MASK] cleaner than humans ? [SEP]	rats	Q36396	clean
[CLS] is it true a [MASK] mouth is cleaner than a humans ? [SEP]	dogs	Q144	clean
[CLS] a [MASK] s tongue weighs more than an elephant . . . is that true ? [SEP]	Blue whale	Q42196	mass
[CLS] which is cute ##r poll - [MASK] or pup ##pies ? [SEP]	Kittens	Q147	cute
[CLS] which animal is stronger an [MASK] or a silver ##back gorilla ? [SEP]	orangutan	Q41050	strength
[CLS] is a [MASK] mouth really cleaner than a human ' s ? [SEP]	dog's	Q144	clean
[CLS] is it true that [MASK] po ##op smells much worse than dog po ##op ? how would you describe the smell ? [SEP]	cat	Q146	smelly
[CLS] do dwarf [MASK] smell worse than fish ? [SEP]	hamsters	Q6573	smelly
[CLS] why would most of us easily kill tiny creatures like [MASK] but few would harm larger creatures like squirrels ? [SEP]	ants	Q7386	other
[CLS] what do you think it cute ##r mini da ##chs ##hun ##d or a pu ##g ? [SEP]	mini dachshund	Q12664827	other
[CLS] what ##s faster : a [MASK] or a rabbit ? [SEP]	dog	Q144	speed
[CLS] what ##s better a rob ##oro ##vs ##ki or [MASK] ! ? [SEP]	siberian dwarf hamster	Q214633	other
[CLS] what ' s easier to care for bet ##tas or [MASK] [SEP]	Guppies	Q178202	other
[CLS] what smells worse a turtle or [MASK] [SEP]	lizard	Q15879	smelly
[CLS] which dog is cute ##r - a newfoundland or [MASK] [SEP]	Golden Retriever	Q38686	cute
[CLS] why are [MASK] so much stronger than humans if we evolved from them ? [SEP]	chimpanzees	Q4126704	strength
[CLS] who is friend ##lier when tame ##d a lion or [MASK] and why ? [SEP]	tiger	Q19939	friendliness
[CLS] bats may be higher in number in a habitat with abundant flying [MASK] and ro ##ost ##ing sites , but lower where the ? [SEP]	insects	Q1390	height
[CLS] does a leopard run faster than a [MASK] [SEP]	lion	Q140	speed
[CLS] do bees [MASK] higher than flies ? [SEP]	fly	Q25312	height
[CLS] how much longer is a blue whale int ##est ##ine than a [MASK] [SEP]	humans	Q15978631	length
[CLS] which is better a [MASK] or a dwarf ham ##ster ? [SEP]	guinea pig	Q79803	other
[CLS] which smells worse ? a [MASK] or rabbit ? [SEP]	ferret	Q178973	smelly
[CLS] what runs faster ? a [MASK] a can ##tal ##ou ##pe , or a leopard ? your honest opinion or knowledge . ? [SEP]	Deer	Q23390	speed
[CLS] which is more affection ##ate : a weimar ##ane ##r or a [MASK] [SEP]	German Shepherd	Q38280	friendliness
[CLS] are cats smarter then [MASK] [SEP]	dogs	Q144	intelligence
[CLS] which is more intelligent , a [MASK] or guinea pig ? [SEP]	rabbit	Q9394	intelligence
[CLS] which is more irritating - - - - [MASK] cr ##oa ##king or crows cracking ? [SEP]	frogs	Q53636	other
[CLS] are chi ##mp ##an ##zee ##s really stronger than [MASK] [SEP]	chimpanzees	Q4126704	strength
[CLS] guinea pig vs . [MASK] which one ' s smarter ? [SEP]	Rabbit	Q9394	intelligence
[CLS] which fish live longer . . . a gu ##ppy or a [MASK] [SEP]	beta fish	Q549	lifespan
[CLS] which pet is more loving ? [MASK] or ge ##rb ##il ? [SEP]	Hamster	Q6573	friendliness
[CLS] is a dwarf ham ##ster a good first pet ? or is a [MASK] better ? [SEP]	Syrian hamster	Q204175	other
[CLS] what smells worse : pet [MASK] or mice ? [SEP]	ferrets	Q178973	smelly
[CLS] what is the scientific fact , cat or [MASK] who is dirt ##ier ? [SEP]	dog	Q144	clean
[CLS] which one is more expensive , a rot ##t ##weiler or [MASK] [SEP]	german shepherd	Q38280	price
[CLS] which is cute ##r poll - kitten ##s or [MASK] ? [SEP]	Kittens	Q147	cute
[CLS] what do you think is cute ##r deer head [MASK] or apple heads ? [SEP]	Chihuahuas	Q653	cute
[CLS] why do people say border col ##lies are smarter than [MASK] [SEP]	Poodles	Q38904	other
[CLS] why are [MASK] smarter than cats ? [SEP]	dogs	Q144	intelligence
[CLS] mar ##mos ##et or [MASK] which is a better family monkey ? [SEP]	capuchin	Q326260	other
[CLS] are cats more intelligent than [MASK] . . ? [SEP]	dogs	Q144	intelligence
[CLS] pit ##bu ##ll , [MASK] which has a stronger bite ? [SEP]	rotweiler	Q39093	other
[CLS] why is the black rhino more endangered than the [MASK] [SEP]	white rhino	Q159918	endangered
[CLS] are [MASK] teeth cleaner than humans teeth ? [SEP]	dogs	Q144	clean
[CLS] at ##hi ##est and evolution ##ist , can science explain why this [MASK] s dna is more like a wolf ' s than other gi ##raf ##fe ##s ? [SEP]	giraffe	Q862089	other
[CLS] which are cute ##r : baby pup ##pies or baby [MASK] [SEP]	Kittens	Q147	cute
[CLS] what ' s a better pet [MASK] or lizard ? [SEP]	snake	Q2102	other
[CLS] which r cute ##r bass ##et hounds or [MASK] [SEP]	basset hounds	Q37716	cute
[CLS] which is more dangerous : an un ##tre ##ated human bite or an un ##tre ##ated [MASK] bite ? [SEP]	Black Widow	Q385932	dangerous
[CLS] which is better , a border col ##lie or a [MASK] [SEP]	golden retriever	Q38686	other
[CLS] which ant is more deadly : [MASK] or bullet ants ? [SEP]	Fire Ants	Q1075697	deadly
[CLS] is there any ot ##he [MASK] cute ##r than a york ##ie ! ! ! ? [SEP]	dog	Q144	cute
[CLS] how come [MASK] are so much cute ##r than human babies ? [SEP]	puppies	Q39266	cute
[CLS] is male [MASK] stronger or powerful than the male am ##ur tiger ? [SEP]	african lion	Q140	strength
[CLS] are can ##ids brave ##r than [MASK] [SEP]	felids	Q25265	other
[CLS] are ham ##sters mean ##er than [MASK] [SEP]	bunnies	Q9394	mean
[CLS] are [MASK] mouth cleaner than humans ? [SEP]	dogs	Q144	clean
[CLS] which has better looking legs , a sea ##gul ##l or a [MASK] ? [SEP]	chicken	Q780	other
[CLS] chi ##mp ##an ##zee ##s are al ##ot stronger than [MASK] . . ? [SEP]	Chimpanzees	Q4126704	strength
[CLS] cats vs [MASK] which is smarter ? who ' s the better pet ? etc . ? [SEP]	DOGS	Q144	intelligence
[CLS] which one is better ? [MASK] or pit ##bu ##ll ? [SEP]	German Shepherd	Q38280	other
[CLS] who is smarter coyotes or [MASK] [SEP]	wolves	Q18498	intelligence
[CLS] which breed is more loyal : [MASK] or the jin ##do dog ? [SEP]	Bernese mountain dog	Q37608	loyal
[CLS] does a [MASK] have a cleaner mouth than a dog ? [SEP]	cat	Q146	smelly
[CLS] can a rat survive longer than a [MASK] without water ? [SEP]	camel	Q7375	lifespan
[CLS] why do nerve impulse ##s need to travel faster in a [MASK] than in a earth ##worm ? [SEP]	human	Q15978631	other
[CLS] which is bigger , [MASK] or ge ##rb ##ils ? [SEP]	hamsters	Q6573	size
[CLS] why can lizards not produce urine that is more concentrated than [MASK] [SEP]	mammals	Q7377	other
[CLS] are lions taller than [MASK] on all fours ? [SEP]	tigers	Q19939	height
[CLS] bet ##tas vs . [MASK] which are better for the begin ##ner with a small tank ? a few other questions . . . ? [SEP]	Guppies	Q178202	other
[CLS] what animal could live longer , a whale or a [MASK] [SEP]	Turtle	Q223044	lifespan
[CLS] why is [MASK] more expensive than pink ? [SEP]	red salmon	Q44064	price
[CLS] is a squirrel more agile than a [MASK] [SEP]	cat	Q146	other
[CLS] which is cute ##r - kitten ##s or [MASK] [SEP]	kittens	Q147	cute
[CLS] can dogs hear better then [MASK] ? ? ? ? [SEP]	humans	Q15978631	hearing
[CLS] what is more dangerous a [MASK] or a ty ##ran ##nos ##aur ? [SEP]	raptor	Q48428	other
[CLS] why are al ##pac ##as way more expensive than [MASK] [SEP]	llamas	Q42569	price
[CLS] what smells worse : chin ##chi ##llas or [MASK] i also have some questions . 10 pts best answer ? [SEP]	Chinchillas	Q192930	smelly
[CLS] which is more dangerous a [MASK] or an os ##tric ##h ? [SEP]	shark	Q7372	dangerous
[CLS] what is longer a [MASK] s neck or an elephant ' s trunk ? [SEP]	giraffe	Q862089	length
[CLS] who is smarter cats or [MASK] [SEP]	dogs	Q144	intelligence
[CLS] which is better for a college pet : a small lizard or [MASK] [SEP]	freshwater fish	Q1072742	other
[CLS] which is heavier , a hip ##po or an [MASK] [SEP]	elephant	Q7378	mass
[CLS] poll : pit bull or [MASK] which do you like better ? [SEP]	Poodle	Q38904	other
[CLS] which smells worse , [MASK] or dog ? [SEP]	cat	Q146	smelly
[CLS] is a [MASK] bigger than a deer ? [SEP]	wolf	Q18498	size
[CLS] which would be a better pet for our 11 year old , a [MASK] or lizard ? [SEP]	snake	Q2102	other
[CLS] which smell worse , bun ##nies or [MASK] or do either smell bad at all ? [SEP]	hedgehogs	Q6120	smelly
[CLS] which is faster , a turtle on a jet airplane or a [MASK] locked under a milk crate ? [SEP]	rabbit	Q9394	speed
[CLS] is a [MASK] mouth really cleaner that a humans ? [SEP]	dogs	Q144	clean
[CLS] bud ##gie or [MASK] which one is more affection ##ate ? [SEP]	cockatiel	Q514809	friendliness
[CLS] which ant is more deadly : fire ants or [MASK] [SEP]	Bullet Ants	Q73901	deadly
[CLS] why does kitten po ##o smell worse than [MASK] po ##o ? [SEP]	Cat	Q146	smelly
[CLS] what sounds better / cooler ? wolf girl or [MASK] girl ? [SEP]	tiger	Q19939	other
[CLS] are [MASK] smarter than cats ? [SEP]	kittens	Q147	intelligence
[CLS] how much stronger is a ko ##dia ##k bear than an average [MASK] [SEP]	human	Q15978631	strength
[CLS] what smells worse rabbits or [MASK] [SEP]	ferrets	Q178973	smelly
[CLS] which is stronger a star trek k ##ling ##on or an original ' planet of the [MASK] gorilla ? [SEP]	Apes	Q102470	strength
[CLS] which one is more expensive , a [MASK] or german shepherd ? [SEP]	rottweiler	Q39093	price
[CLS] what can a wolf do that a [MASK] can ' t do since wolf ##s are more intel ##igen ##t than a dog ? [SEP]	wolf	Q18498	other
[CLS] what is animal is better : jack ##alo ##pes , [MASK] flying penguins or squirrels ? [SEP]	Llamas	Q42569	other
[CLS] border col ##lie or [MASK] better for protection ? [SEP]	syberian husky	Q39295	other
[CLS] are cats really smarter than [MASK] [SEP]	dogs	Q144	intelligence
[CLS] are fish smarter than [MASK] [SEP]	dogs	Q144	intelligence
[CLS] which animal is smarter : guinea pigs or [MASK] [SEP]	parakeets	Q8329	intelligence
[CLS] which are cute ##r : pup ##pies or [MASK] [SEP]	kittens	Q147	cute
[CLS] which is easier to breed : [MASK] or bet ##ta ' s ? 10 points for best answer ! ! ? [SEP]	Gouramis	Q726399	other
[CLS] why is a [MASK] mouth cleaner than a human ' s mouth ? [SEP]	dog's	Q144	clean
[CLS] what is smarter cats or [MASK] [SEP]	dogs	Q144	intelligence
[CLS] who is the faster , a [MASK] or a rabbit ? [SEP]	mouse	Q2751034	speed
[CLS] is ham ##ster cute ##r then [MASK] ? [SEP]	rabbit	Q9394	cute
[CLS] can a cat outs ##mart a [MASK] how smarter are dogs in general ? how is cat intelligence measured ? [SEP]	cat	Q146	intelligence
[CLS] are german shepherd ##s smarter than [MASK] or are border col ##lies smarter than german shepherd ##s ? [SEP]	Border Collies	Q37710	intelligence
[CLS] poll : which are cute ##r [MASK] or kitten ##s ? [SEP]	kittens	Q147	cute
[CLS] why do [MASK] and other animals age so much faster than humans . ? [SEP]	dogs	Q144	lifespan
[CLS] which animal is smarter ? a cat or a [MASK] [SEP]	dog	Q144	intelligence
[CLS] what do you think is cleaner cats or [MASK] [SEP]	dogs	Q144	clean
[CLS] which is cute ##r ? [MASK] or chin ##chi ##lla ? [SEP]	Guinea pig	Q79803	cute
[CLS] why can dogs hear better than [MASK] [SEP]	humans	Q15978631	hearing
[CLS] why do [MASK] live longer than humans ? [SEP]	elephants	Q7378	lifespan
[CLS] why are pure breed dogs and [MASK] so much more expensive than mixed breed dogs and cats ? [SEP]	Pure Breed dogs	Q39120	price
[CLS] is a [MASK] stronger than a mouse ? [SEP]	rat	Q36396	strength
[CLS] are [MASK] stronger than humans ? [SEP]	snakes	Q2102	strength
[CLS] [MASK] or fe ##rret : which is more expensive to properly care for ? [SEP]	Chinchilla	Q192930	price
[CLS] which dog breed is cute ##r ? a [MASK] vs york ##ie ! ! ? [SEP]	maltese	Q38751	cute
[CLS] how is a chi ##mp ##an ##zee 3 ##x stronger than a [MASK] [SEP]	chimpanzee	Q4126704	strength
[CLS] do [MASK] have better hearing than rabbits ? [SEP]	Bats	Q28425	hearing
[CLS] who do you think is smarter . . . [MASK] or cats ? [SEP]	dogs	Q144	intelligence
[CLS] which dog is cheaper to own , golden retrieve ##r or [MASK] [SEP]	Newfoundland	Q38706	price
[CLS] are [MASK] easier to breed than bet ##ta fish ? [SEP]	Guppy fish	Q178202	other
[CLS] why are chi ##mp ##an ##zee ##s so much stronger than [MASK] if we evolved from them ? [SEP]	chimpanzees	Q4126704	strength
[CLS] why is [MASK] pregnancy shorter than the average human ' s ? [SEP]	dog's	Q144	length
[CLS] what would be better , a border col ##lie or [MASK] [SEP]	lab	Q38726	other
[CLS] can you put a slightly larger sul ##cat ##a tor ##to ##ise in with a slightly smaller cherry headed [MASK] [SEP]	red footed tortoise	Q277794	other
[CLS] which animal would have a longer ali ##ment ##ary canal for its size , a wolf or a [MASK] [SEP]	sheep	Q7368	other
[CLS] is a german she ##pher ##s a better [MASK] than a pit ##bu ##ll ? [SEP]	dog	Q144	other
[CLS] do dog far ##ts really smell much worse than [MASK] far ##ts ? describe the smell ? [SEP]	human	Q15978631	smelly
[CLS] my new kitten ##s tail is very long , it is longer than my 4 year old [MASK] what does it me ? [SEP]	cats	Q146	length
[CLS] can a [MASK] survive longer than a camel without water ? [SEP]	rat	Q36396	lifespan
[CLS] why is trout more expensive than [MASK] [SEP]	salmon	Q2796766	price
[CLS] polls and surveys - which is cute ##r - ducks or [MASK] . . ? [SEP]	penguin	Q9147	cute
[CLS] can [MASK] hear better than humans ? [SEP]	dogs	Q144	hearing
[CLS] when it comes to vet bills , are [MASK] more expensive than rats ? [SEP]	ferrets	Q178973	price
[CLS] do [MASK] really have better hearing than humans ? [SEP]	dog	Q144	hearing
[CLS] are cats smarter than [MASK] or are dogs smarter than cats ? [SEP]	Cats	Q146	intelligence
[CLS] is a [MASK] or a pu ##g a better dog ? [SEP]	chihuahua	Q653	other
[CLS] why are adult dogs more expensive than [MASK] [SEP]	puppies	Q39266	price
[CLS] which is bigger a li ##ger or a [MASK] [SEP]	tiger	Q19939	size
[CLS] am i the only person who thinks sw ##ipe ##r from dora the explorer looks more like a weasel than a [MASK] [SEP]	fox	Q8331	other
[CLS] true or false : hip ##po ##s weigh more than [MASK] [SEP]	elephants	Q7378	mass
[CLS] which is bigger a [MASK] or love ##bird ? and which one can be trained to talk easier ? [SEP]	budgie	Q121221	size
[CLS] which one is cute ##r golden retrieve ##r or [MASK] [SEP]	golden retriever	Q38686	cute
[CLS] describe two ways earth ##worm ##s are more advanced relative to [MASK] [SEP]	flatworms	Q124900	other
[CLS] will [MASK] or a lizard ( not big ) make a better pet ? [SEP]	hermit crabs	Q273291	other
[CLS] how is a chi ##mp stronger then a [MASK] [SEP]	chimp	Q4126704	strength
[CLS] what are better [MASK] border col ##lies or hu ##ske ##ys ? [SEP]	dogs	Q144	other
[CLS] true or false : [MASK] weigh more than elephants ? [SEP]	Hippos	Q34505	mass
[CLS] which is one is faster ? a [MASK] or a ll ##ama ? [SEP]	roadrunner	Q1452250	speed
[CLS] is a whip ##pet faster then a [MASK] [SEP]	Greyhound	Q38571	speed
[CLS] why sea animals live longer than [MASK] including humans ? [SEP]	land animals	Q3248864	lifespan
[CLS] are the mouths of [MASK] really cleaner with their ge ##rm ##s , etc . , than humans ? [SEP]	dogs	Q144	clean
[CLS] whose mouth is cleaner a cats or a d [MASK] [SEP]	og?	Q144	clean
[CLS] which is heavier , a [MASK] or an elephant ? [SEP]	hippo	Q34505	mass
[CLS] physiological ##ly : why are [MASK] so much stronger than people ? [SEP]	apes	Q102470	strength
[CLS] which smells worse ? male or female pee / po ##o kitten / [MASK] smell ? [SEP]	cat	Q146	smelly
[CLS] which is more mach ##o - bringing your [MASK] to the bowling alley , or your pit ##bu ##ll to a fashion show ? [SEP]	poodle	Q38904	other
[CLS] are [MASK] mouths really cleaner than human ' s ? [SEP]	dog's	Q144	clean
[CLS] why is dog ' s pregnancy shorter than the average [MASK] s ? [SEP]	dog's	Q144	length
[CLS] why does red salmon cost more than [MASK] [SEP]	pink salmon	Q673380	price
[CLS] do you like sea ##gul ##ls or [MASK] better ? [SEP]	CROWS	Q388450	other
[CLS] which is smarter : a cat or [MASK] [SEP]	dog	Q144	intelligence
[CLS] is a [MASK] mouth cleaner than a human ' s mouth ? [SEP]	dog's	Q144	clean
[CLS] are snow leopard ##s more endangered than [MASK] [SEP]	Lynxes	Q677014	endangered
[CLS] what is cute ##r ? a monkey ? a [MASK] or patrick stump ? [SEP]	Koala	Q36101	cute
[CLS] are [MASK] or chickens more intelligent ? [SEP]	ducks	Q3736439	intelligence
[CLS] which are better pets : [MASK] or bet ##ta fish ? [SEP]	bearded dragons	Q743973	other
[CLS] poll : what has better looking legs , a sea ##gul ##l or a [MASK] ? [SEP]	chicken	Q780	other
[CLS] is a wolf a better group leader than an [MASK] or is an eagle a better group leader than a wolf ? [SEP]	wolf	Q18498	other
[CLS] why can [MASK] run faster than alligator ##s ? [SEP]	crocodiles	Q2535664	speed
[CLS] do [MASK] smell worse than ham ##sters ? i also have some questions . best answer 10 pts ? [SEP]	gerbils	Q244770	smelly
[CLS] what is smarter , a cat or a [MASK] [SEP]	rabbit	Q9394	intelligence
[CLS] is it true that cats are smarter than [MASK] [SEP]	dogs	Q144	intelligence
[CLS] do [MASK] have way better hearing that humans ? [SEP]	cats	Q146	hearing
[CLS] what ' s cute ##r ? - pup ##pies , [MASK] or babies ? [SEP]	kittens	Q147	cute
[CLS] which are cute ##r : kitten ##s or [MASK] and why ? [SEP]	kittens	Q147	cute
[CLS] why are people more dangerous to [MASK] than they are to humans ? [SEP]	sharks	Q7372	dangerous
[CLS] which breed is more loyal : bern ##ese mountain dog , or the [MASK] [SEP]	Bernese mountain dog	Q37608	loyal
[CLS] are [MASK] mouths really cleaner than humans ? [SEP]	dogs	Q144	clean
[CLS] can [MASK] run faster than dogs and why ? [SEP]	humans	Q15978631	speed
[CLS] which are cute ##r ham ##sters or [MASK] [SEP]	bunnies	Q9394	cute
[CLS] which do you think is cute ##r . . . [MASK] or kitten ##s ? [SEP]	kittens	Q147	cute
[CLS] which is better a [MASK] or a lizard ? [SEP]	bunny	Q9394	other
[CLS] who is stronger out of li ##ger and [MASK] [SEP]	liger	Q182573	strength
[CLS] are [MASK] really stronger than humans ? [SEP]	chimpanzees	Q4126704	strength
[CLS] r there any [MASK] stronger than humans ? [SEP]	primates	Q7380	strength
[CLS] what smells worse : [MASK] or ge ##rb ##il urine ? 10 pts best answer ? [SEP]	Gerbil	Q244770	smelly
[CLS] how many times more deadly is a [MASK] than a wolf and is this difference significant ? [SEP]	Lion	Q140	deadly
[CLS] is a pu ##g easier to care for than a [MASK] [SEP]	chihuahua	Q653	other
[CLS] who is stronger out of [MASK] and ti ##gon ? [SEP]	liger	Q182573	strength
[CLS] which is cute ##r ? - [MASK] or kitten ##s ? [SEP]	kittens	Q147	cute
[CLS] which do you think is worse - a bite from a [MASK] or a black widow ? [SEP]	brown recluse	Q284352	other
[CLS] is a chi ##mp ##an ##zee still stronger than the strongest [MASK] male ever ? stronger than a human male with the world ? [SEP]	Chimpanzee	Q4126704	strength
[CLS] why would a [MASK] cell require more mit ##och ##ond ##ria than lizards ? [SEP]	mammal	Q7377	other
[CLS] what smells worse ? dog far ##ts , or [MASK] far ##ts ? [SEP]	cat	Q146	smelly
[CLS] full grown male asiatic lion vs full grown male [MASK] who will win in a fight . who is more powerful ? [SEP]	bengal tiger	Q80952	strength
[CLS] are [MASK] more intelligent than cats ? [SEP]	dogs	Q144	intelligence
[CLS] do [MASK] live longer than dogs ? [SEP]	cats	Q146	lifespan
[CLS] why would lizards not have more al ##ve ##oli per unit area than [MASK] [SEP]	mammals	Q7377	other
[CLS] generally speaking , what are more affection ##ate , rabbits or [MASK] [SEP]	guinea pigs	Q79803	friendliness
[CLS] which animal is smarter , a [MASK] or chicken ? [SEP]	squirrel	Q9482	intelligence
[CLS] which is faster the em ##u or [MASK] [SEP]	kangaroo	Q5070208	speed
[CLS] witch can find a way out of a cage easier a [MASK] or a lizard ? [SEP]	snake	Q2102	other
[CLS] are [MASK] cleaner than humans ? [SEP]	dogs	Q144	clean
[CLS] which is faster , a [MASK] on a jet airplane or a rabbit locked under a milk crate ? [SEP]	turtle	Q223044	speed
[CLS] are [MASK] smarter than cats or vice versa ? [SEP]	dogs	Q144	intelligence
[CLS] what ##s better , [MASK] or a dwarf ham ##ster ? [SEP]	Syrian hamster	Q204175	other
[CLS] which fish lives longer : bet ##ta or [MASK] [SEP]	Goldfish	Q123141	other
[CLS] poll : which are cute ##r ; pup ##pies or [MASK] [SEP]	kittens	Q147	cute
[CLS] are [MASK] stronger then humans ? [SEP]	dogs	Q144	strength
[CLS] which breed is sweet ##er ? the pu ##g or the mina ##ture [MASK] [SEP]	pinscher	Q38990	other
[CLS] are [MASK] mouths cleaner than humans ? [SEP]	dogs	Q144	clean
[CLS] is the hair of a [MASK] or a maltese longer and how long is it ? [SEP]	Shih-tzu	Q39357	length
[CLS] which would make a better pet dog : pu ##g or [MASK] [SEP]	sheepdog	Q38390	other
[CLS] survey ~ what is cute ##r . . pup ##pies or [MASK] [SEP]	Kittens	Q147	cute
[CLS] how much stronger is a [MASK] s vision compared to a human ' s vision ? [SEP]	Hawk	Q846664	strength
[CLS] do you believe that pit ##bu ##lls are more aggressive than other [MASK] [SEP]	dogs	Q144	other
[CLS] r & s poll : which is cute ##r ? baby [MASK] or baby gi ##raf ##fe ##s ? [SEP]	Elephants	Q7378	cute
[CLS] who is stronger - the strongest human on earth or an average [MASK] [SEP]	chimpanzee	Q4126704	strength
[CLS] what ##s better to buy 2 rob ##o ham ##sters or one [MASK] [SEP]	syrian hamster	Q204175	other
[CLS] poll : witch is faster ? [MASK] or rabbit ? ? [SEP]	turtle	Q223044	speed
[CLS] why are cardinal te ##tra ##s more expensive than neon te ##tra ##s ? [SEP]	cardinal tetras	Q590731	price
[CLS] which breed of dog has more fragile bones ? a pu ##g or [MASK] [SEP]	maltese	Q38751	other
[CLS] why are more people afraid of [MASK] than crabs ? [SEP]	Spiders	Q1357	dangerous
[CLS] will dogs and [MASK] live longer in the future ? [SEP]	cats	Q146	lifespan
[CLS] what ' s faster a cat or a [MASK] [SEP]	dog	Q144	speed
[CLS] are li ##gers bigger than extinct [MASK] [SEP]	American Lions	Q242358	size
[CLS] is a [MASK] mouth is cleaner than a human ' s ? [SEP]	dog's	Q144	clean
[CLS] do wolves hear better than [MASK] [SEP]	foxes	Q8332	hearing
[CLS] do [MASK] smell bad ? ( worse than ge ##rb ##ils ) , i ' m trying to adopt one but my mom thinks they are evil . ? [SEP]	gerbils	Q244770	smelly
[CLS] why are gorilla ##s so much stronger than [MASK] [SEP]	gorillas	Q36611	strength
[CLS] which is more intelligent a [MASK] or a cat , and why did you choose the one you are answering ? [SEP]	dog	Q144	intelligence
[CLS] is a [MASK] mouth cleaner than a human ' s ? [SEP]	cat's	Q146	clean
[CLS] why are dogs more expensive than [MASK] [SEP]	cats	Q146	price
[CLS] who is stronger a average male [MASK] or a average male gorilla ? [SEP]	bear	Q11788	strength
[CLS] which is stronger ( [MASK] vs . elephant ) ? [SEP]	rhino	Q34718	strength
[CLS] what smells worse : ham ##ster or [MASK] urine ? 10 pts best answer ? [SEP]	Gerbil	Q244770	smelly
[CLS] could a quarter ##horse [MASK] mix be faster than a thoroughbred ? [SEP]	quarterhorse	Q466602	speed
[CLS] which is faster a [MASK] or a dog ? [SEP]	cat	Q146	speed
[CLS] who lives longer [MASK] or wolves and why ? [SEP]	dogs	Q144	other
[CLS] is a [MASK] mouth really cleaner then a human ' s ? [SEP]	dog's	Q144	clean
[CLS] which is smarter ? a siberian husky or a [MASK] [SEP]	German shepherd	Q38280	intelligence
[CLS] are beta fish or [MASK] better pets ? [SEP]	goldfish	Q123141	other
[CLS] are cats more intelligent or [MASK] [SEP]	dogs	Q144	intelligence
[CLS] what is bigger , a panther or [MASK] [SEP]	wolf	Q18498	size
[CLS] in a fight to the death adult african male [MASK] vs adult male am ##ur tiger who will win in a fight . who stronger [SEP]	lion	Q140	strength
[CLS] why do wolves have larger and more curved teeth then [MASK] [SEP]	dogs	Q144	other
[CLS] do [MASK] or english bulldogs shed more than pu ##gs ? [SEP]	french bulldogs	Q29149	other
[CLS] are alligator ##s less dangerous ( relatively speaking ) than [MASK] [SEP]	crocodiles	Q2535664	dangerous
[CLS] which species are cute ##r , ducks or [MASK] [SEP]	turtles	Q223044	cute
[CLS] is your [MASK] or cat smarter than sarah pali ##n ? [SEP]	dog	Q144	intelligence
[CLS] what runs faster ? a [MASK] or a rhino ? [SEP]	hippo	Q34505	speed
[CLS] who is stronger - the strongest [MASK] on earth or an average chi ##mp ##an ##zee ? [SEP]	chimpanzee	Q4126704	strength
[CLS] what is smarter , a [MASK] or a rabbit ? [SEP]	cat	Q146	intelligence
[CLS] who is smarter a pig or a [MASK] [SEP]	rat	Q36396	intelligence
[CLS] who is faster a sail ##fish or a [MASK] [SEP]	cheetah	Q23907	speed
[CLS] are [MASK] tongues really cleaner than a humans tongue ? [SEP]	dogs	Q144	clean
[CLS] poll : my puppy ( mu ##tt ) or pure bred [MASK] which is cute ##r ? [SEP]	CHIHUAHUA	Q653	cute
[CLS] which is nice ##r - a russian [MASK] or a chinese dwarf ham ##ster ? [SEP]	Winter White hamster	Q214633	other
[CLS] what is more expensive a [MASK] or dog ? [SEP]	cat	Q146	price
[CLS] which is cute ##r ? full grown ducks or baby yellow [MASK] [SEP]	Chickens	Q780	cute
[CLS] which is better for bet ##tas [MASK] or blood ##worm ##s ? [SEP]	brine shrimp	Q134772	other
[CLS] which is the better pet ? leopard ge ##cko vs . bet ##ta fish ? [SEP]	Leopard gecko	Q256860	other
[CLS] is a [MASK] cute ##r than a boston terri ##er ? [SEP]	Shih Tzu	Q39357	cute
[CLS] are [MASK] or dogs more expensive ? [SEP]	cats	Q146	price
[CLS] i ' m doing an 8th grade research paper for ' whose mouth is cleaner , a [MASK] or a humans and can ##t find anything ! [SEP]	dogs	Q144	clean
[CLS] which is better in general : [MASK] or pu ##g ? [SEP]	Chihuahua	Q653	other
[CLS] what is better for a pet : a [MASK] or a lizard ? [SEP]	hamster	Q6573	other
[CLS] why are [MASK] so much cute ##r than human babies ? [SEP]	puppies	Q39266	cute
[CLS] do squirrels share more characteristics with squirrels or [MASK] [SEP]	mice	Q2751034	other
[CLS] which are cute ##r : [MASK] or bea ##gles ? [SEP]	BEAGLES	Q21102	cute
[CLS] if the mom who is a [MASK] 14 pounds how much will the puppy weigh full grown ? will the puppy weigh less or mor ? [SEP]	poodle	Q38904	mass
[CLS] what is longer a gi ##raf ##fe ' s neck or an [MASK] s trunk ? [SEP]	elephant	Q7378	length
[CLS] what animal can run faster - - the war ##t hog or the [MASK] [SEP]	giraffe	Q862089	speed
[CLS] poll : which are cute ##r : [MASK] or kit ##ties ? [SEP]	Kitties	Q147	cute
[CLS] what ##s faster : a dog or a [MASK] [SEP]	rabbit	Q9394	speed
[CLS] what are you more scared of : [MASK] or slug ##s ? [SEP]	Sharks	Q7372	dangerous
[CLS] why would end ##oth ##er ##my be less important for the giant sa ##uri ##sch ##ians than for small [MASK] [SEP]	dinosaurs	Q430	other
[CLS] are humans stronger than [MASK] [SEP]	dogs	Q144	strength
[CLS] baby [MASK] or baby cats ? ? ? ? ? ? which is cute ##r ? [SEP]	HUMANS	Q15978631	cute
[CLS] do [MASK] smell better than dogs ? [SEP]	cats	Q146	smelly
[CLS] is the alligator or [MASK] more dangerous ? [SEP]	crocodile	Q2535664	dangerous
[CLS] poll : are cats smarter than [MASK] [SEP]	dogs	Q144	intelligence
[CLS] who ##s cute ##r ? a - cat or a - [MASK] [SEP]	Dog	Q144	cute
[CLS] ? what is stronger a [MASK] or a elephant ? [SEP]	komodo dragon	Q4504	strength
[CLS] what ' s faster a [MASK] or a dog ? [SEP]	cat	Q146	speed
[CLS] dogs have cleaner mouths than [MASK] this is not true ! ? [SEP]	humans	Q15978631	smelly
[CLS] are spotted h ##yen ##as more dangerous than [MASK] [SEP]	striped hyenas	Q188657	dangerous
[CLS] lizard or [MASK] w ##hic ##e is better ? [SEP]	snake	Q2102	other
[CLS] is it true that girl cats are usually mean ##er than boy cats when i comes to interacting with [MASK] [SEP]	humans	Q15978631	mean
[CLS] which is scar ##ier , a [MASK] or an alligator ? [SEP]	crocodile	Q2535664	dangerous
[CLS] is there a possibility of a species such as wolves super ##ced ##ing [MASK] as the dominant , more intelligent being ? [SEP]	humans	Q15978631	other
[CLS] which is cheaper to maintain an adult [MASK] or greek tor ##to ##ise ? [SEP]	bearded dragon	Q743973	price
[CLS] which animal is faster ; a [MASK] or a gr ##izzly bear ? [SEP]	thoroughbred racehorse	Q210826	speed
[CLS] which is faster a [MASK] or turtle ? [SEP]	frog	Q53636	speed
[CLS] whose mouth is cleaner a [MASK] or a frogs ? [SEP]	Turtles	Q223044	clean
[CLS] is a [MASK] more powerful ! then a do ##berman ? [SEP]	bullmastiff	Q38080	strength
[CLS] who is stronger a boxer or [MASK] [SEP]	Pitbull	Q1144318	strength
[CLS] who is smarter ? a [MASK] or a rabbit ? [SEP]	duck	Q3736439	intelligence
[CLS] where can i find a squirrel or [MASK] for sale ? [SEP]	greater glider	Q668004	other
[CLS] which are smarter ? cats / [MASK] points to ponder . ? [SEP]	dogs	Q144	intelligence
[CLS] about how much stronger is a chi ##mp ##an ##zee than a [MASK] [SEP]	chimpanzee	Q4126704	strength
[CLS] why do tropical birds like [MASK] live longer than other birds ? [SEP]	parrots	Q31431	lifespan
[CLS] which can run faster ? a cat or a [MASK] [SEP]	dog	Q144	speed
[CLS] do pu ##gs have more separation anxiety than other [MASK] how long do you leave yours by themselves ? [SEP]	dogs	Q144	other
[CLS] are [MASK] smarter than german shepherd ##s ? [SEP]	Airedale Terriers	Q37617	intelligence
[CLS] who is smarter [MASK] or cats ? [SEP]	dogs	Q144	intelligence
[CLS] are [MASK] smarter then chickens ? [SEP]	turkeys	Q43794	intelligence
[CLS] which is cute ##r , a [MASK] or a bea ##gle ? [SEP]	beagle	Q21102	cute
[CLS] what is cleaner and more h ##y ##gie ##nic , a [MASK] or a cat ? [SEP]	rabbit	Q9394	clean
[CLS] what is better a [MASK] or a dwarf ham ##ster ? [SEP]	syrian hamster	Q204175	other
[CLS] if a [MASK] was the size of a siberian tiger would it be stronger ? [SEP]	house cat	Q146	strength
[CLS] can dogs hear better than [MASK] [SEP]	humans	Q15978631	hearing
[CLS] what ##s better t - rex or [MASK] [SEP]	spinosaurus	Q130966	other
[CLS] were there any [MASK] bigger than the me ##so ##the ##la ##e in the prehistoric times ? [SEP]	spiders	Q1357	size
[CLS] what is faster a rabbit or a [MASK] [SEP]	cat	Q146	speed
[CLS] which do you like better : [MASK] or weasel ? [SEP]	Monkey	Q1367	other
[CLS] do pit ##bu ##ll [MASK] have a greater chance getting par ##vo than other breeds ? [SEP]	puppies	Q39266	other
[CLS] what ' s cute ##r : baby ducks or [MASK] [SEP]	bunny rabbits	Q9394	cute
[CLS] what is smarter a salt ##water crocodile or a [MASK] and tell me why ? [SEP]	great white shark	Q129026	intelligence
[CLS] what is more dangerous an alligator or a [MASK] [SEP]	crocodile	Q2535664	dangerous
[CLS] are bea ##gles cheaper or more expensive than [MASK] [SEP]	Shih tzus	Q39357	price
[CLS] how come pup ##pies are so much cute ##r than [MASK] babies ? [SEP]	human	Q15978631	cute
[CLS] are cats much more intelligent than [MASK] [SEP]	dogs	Q144	intelligence
[CLS] if we were squirrels , could you run away from that [MASK] faster than i could run away ? [SEP]	hawk	Q846664	speed
[CLS] is a gorilla stronger , or a [MASK] [SEP]	chimp	Q4126704	strength
[CLS] which is smarter [MASK] or cats ? [SEP]	dogs	Q144	intelligence
[CLS] are [MASK] stronger that humans ? [SEP]	ants	Q7386	strength
[CLS] which is more dangerous : america [MASK] or honey badger ? [SEP]	Wolverine	Q14334	dangerous
[CLS] why are [MASK] so much stronger than humans despite being so much smaller ? [SEP]	chimpanzees	Q4126704	strength
[CLS] which is faster and as accurate , the strike of a [MASK] or the peck of a chicken ? [SEP]	snake	Q2102	speed
[CLS] are fancy mice the same size as ge ##rb ##ils are or are they bigger or smaller ? [SEP]	gerbils	Q244770	size
[CLS] which is better to buy ? border col ##lie or [MASK] [SEP]	beagle	Q21102	other
[CLS] what ' s better , a cock ##ap ##oo or a border col ##lie and why ? [SEP]	Cockapoo	Q3241878	other
[CLS] li ##ger vs [MASK] : which one is stronger ? [SEP]	Liger	Q182573	strength
[CLS] why do dogs smell worse than [MASK] [SEP]	cats	Q146	smelly
[CLS] pitt ##bu ##ll more aggressive than a [MASK] ? pu ##lee ##ze . . ? [SEP]	terrier	Q38984	other
[CLS] which is more expensive to take care of a [MASK] or a chihuahua ? [SEP]	cat	Q146	price
[CLS] why was the heaviest [MASK] heavier than the heaviest tiger ? [SEP]	human	Q15978631	mass
[CLS] how much stronger are [MASK] s than human ' s ? are they stronger than ever human male body ##bu ##ilde ##rs ? [SEP]	Chimpanzee	Q4126704	strength
[CLS] who smells worse . . . dogs or [MASK] [SEP]	cats	Q146	smelly
[CLS] which is stronger / more durable ? [MASK] hides or wolf hides ? [SEP]	Deer	Q23390	other
[CLS] wat ##s cute ##r [MASK] or puppy ##s ? [SEP]	kittens	Q147	cute
[CLS] killer whale vs [MASK] which is more intelligent ? [SEP]	SPERM WHALE	Q81214	intelligence
[CLS] are turtles faster than [MASK] [SEP]	sloths	Q2274076	speed
[CLS] what is worse [MASK] or moths , ? [SEP]	Spiders	Q1357	other
[CLS] who is stronger ty ##ran ##nos ##aurus or [MASK] [SEP]	spinosaurus	Q130966	strength
[CLS] is [MASK] saliva cleaner than humans ? [SEP]	cat	Q146	clean
[CLS] are [MASK] or rats more expensive to keep ? [SEP]	guinea pigs	Q79803	price
[CLS] can [MASK] hear better then humans ? ? ? ? ? [SEP]	dogs	Q144	hearing
[CLS] which is cleaner , cats or [MASK] [SEP]	dogs	Q144	clean
[CLS] why are small wild [MASK] generally less afraid of humans than larger ones ? [SEP]	birds	Q5113	dangerous
[CLS] why does [MASK] urine smell so much worse than dog urine ? [SEP]	cat	Q146	smelly
[CLS] what ' s cute ##r , [MASK] or kitten ##s ? [SEP]	kittens	Q147	cute
[CLS] which weighs more , an [MASK] or an elephant ? [SEP]	ostrich	Q17592	mass
[CLS] why are wasps so much more vicious than [MASK] [SEP]	bees	Q7391	mean
[CLS] what is faster ? a [MASK] or a german shepherd ? [SEP]	Border Collie	Q37710	speed
[CLS] what is more loyal a [MASK] or pigeon ? [SEP]	parrot	Q31431	loyal
[CLS] witch run faster [MASK] or dogs ? [SEP]	cats	Q146	speed
[CLS] why is red salmon more expensive than [MASK] [SEP]	Pink	Q673380	price
[CLS] is the [MASK] more dangerous then a king cobra , or is a king cobra more dangerous ? [SEP]	salt water crocodile	Q182599	dangerous
[CLS] which pet is dirt ##ier . . . a cat or [MASK] [SEP]	dog	Q144	clean
[CLS] are [MASK] mouths cleaner than humans ? fact / fiction ( use factual information ) ? [SEP]	dogs	Q144	clean
[CLS] which ham ##ster is better for a begin ##ner ? syrian ( teddy [MASK] or dwarf ham ##ster ? [SEP]	bear	Q11788	other
[CLS] which do you like better : [MASK] or bet ##ta , and why ? [SEP]	goldfish	Q123141	other
[CLS] which live longer - [MASK] or dogs ? [SEP]	cats	Q146	lifespan
[CLS] is a pu ##g a good little family [MASK] would female or male be better for kids ? [SEP]	dog	Q144	other
[CLS] poll : what ##s cute ##r kitten ##s or [MASK] [SEP]	kittens	Q147	cute
[CLS] are long haired [MASK] more expensive than smooth haired ? [SEP]	dachshunds	Q29099	price
[CLS] why are small wild birds generally less afraid of [MASK] than larger ones ? [SEP]	humans	Q15978631	dangerous
[CLS] is a [MASK] a better choice than a bass ##et hound for a first time dog owning family ? [SEP]	brittany	Q38156	other
[CLS] which pet is smarter cats or [MASK] [SEP]	dogs	Q144	intelligence
[CLS] what ' s more beautiful ? wolves or [MASK] [SEP]	Tigers	Q19939	other
[CLS] which is worse ? lizard or [MASK] [SEP]	bird	Q5113	other
[CLS] what is a better pet to have ? a [MASK] or a lizard ? [SEP]	snake	Q2102	other
[CLS] explain to me why [MASK] are so much cute ##r than squirrels ? [SEP]	chipmunks	Q85752125	other
[CLS] which dog is more affection ##ate and more likely to let you hold it and sit in your lap ? [MASK] or chihuahua ( male ) ? [SEP]	PUG	Q38698	friendliness
[CLS] are [MASK] breeds more intelligent than wolves ? [SEP]	domesticated dogs	Q144	other
[CLS] survey ? which can run faster between [MASK] and turtles ? [SEP]	Penguins	Q9147	speed
[CLS] are [MASK] mouths really cleaner than a human ' s ? [SEP]	dogs	Q144	clean
[CLS] can a wolf grow larger than a [MASK] [SEP]	great dane	Q5414	other
[CLS] what ' s cute ##r : babies , [MASK] or kit ##ties . ? [SEP]	Kitties	Q147	cute
[CLS] biggest [MASK] and wasp , which one is bigger ? [SEP]	bee	Q7391	size
[CLS] why are [MASK] friend ##lier than humans ? [SEP]	gorillas	Q36611	friendliness
[CLS] [MASK] vs crow ? who is more clever ? [SEP]	Parrot	Q31431	other
[CLS] the larger breed of co ##b , [MASK] type horse ? please answer ! ? [SEP]	clydesdales	Q844058	other
[CLS] com ##par ##ision : do pu ##gs shed more / less / equal to [MASK] [SEP]	Labs	Q38726	other
[CLS] what ##s more dangerous ? a bull [MASK] or a bull elk ? [SEP]	moose	Q35517	dangerous
[CLS] [MASK] mouths are cleaner than human mouths , true of false ? [SEP]	Dogs	Q144	clean
[CLS] for spring [MASK] fishing , which is more important : a setup for lip ##less crank ##s or a setup for ji ##gs and lizards ? [SEP]	bass	Q1224135	other
[CLS] which one is longer [MASK] or killer whale ? [SEP]	great white shark	Q129026	length
[CLS] do dogs have cleaner mouths than [MASK] [SEP]	people	Q15978631	smelly
[CLS] witch run faster cats or [MASK] [SEP]	dogs	Q144	speed
[CLS] which are cute ##r : [MASK] or pup ##pies , and why ? [SEP]	kittens	Q147	cute
[CLS] what animal is smarter cats or [MASK] [SEP]	dogs	Q144	intelligence
[CLS] are te ##tra ##s smarter than [MASK] [SEP]	goldfish	Q123141	intelligence
[CLS] how is a [MASK] stronger then a human ? [SEP]	chimp	Q4126704	strength
[CLS] what is bigger , a [MASK] or a co ##uga ##r ? [SEP]	great dane	Q5414	size
[CLS] is the hair of a shi ##h - t ##zu or a [MASK] longer and how long is it ? [SEP]	Maltese	Q38751	length
[CLS] is it cheaper to own a [MASK] or a dog ? [SEP]	snake	Q2102	price
[CLS] are [MASK] mouths cleaner than humans . . . ? [SEP]	dogs	Q144	clean
[CLS] [MASK] mouths cleaner than human mouths ? [SEP]	Canine	Q144	clean
[CLS] are [MASK] stronger than humans ? [SEP]	wolves	Q18498	strength
[CLS] do i want a guinea pig or a [MASK] wi ##ch is cheaper ? [SEP]	Hamster	Q6573	price
[CLS] did you know that rats can last without water longer than a [MASK] [SEP]	camel	Q7375	length
[CLS] [MASK] vs . co ##rg ##i . . . which would fit our lifestyle better ? [SEP]	Chow Chow	Q29013	other
[CLS] who thinks this is true . [MASK] are smarter than german shepherd ##s ? [SEP]	poodles	Q38904	intelligence
[CLS] which is cute ##r [MASK] or pup ##pies ? [SEP]	kittens	Q147	cute
[CLS] what dog is better ? pu ##g or [MASK] [SEP]	chihuahua	Q653	other
[CLS] [MASK] vs . humans , who ' s cleaner ? experiment , what ##s the independent variable ? [SEP]	Dogs	Q144	clean
[CLS] why chi ##mps are so stronger than [MASK] [SEP]	chimps	Q4126704	strength
[CLS] why are chi ##mp ##an ##zee ##s so much stronger than [MASK] despite being so much smaller ? [SEP]	chimpanzees	Q4126704	strength
[CLS] does a [MASK] run faster than a timber wolf ? [SEP]	Lion	Q140	other
[CLS] is a [MASK] more intelligent than a mosquito ? [SEP]	fly	Q25312	intelligence
[CLS] which is more expensive ? a dog or a [MASK] [SEP]	cat	Q146	price
[CLS] which is better , a pu ##g or a pu ##ggle ? [SEP]	Puggle	Q2620608	other
[CLS] why are cats cute ##r to me than [MASK] [SEP]	dogs	Q144	cute
[CLS] which spec ##ie is smarter ? [MASK] or whales ? [SEP]	Dolphins	Q7369	intelligence
[CLS] my 6 ##yr . old wants to know , which runs faster , a squirrel or a [MASK] [SEP]	rabbit	Q9394	other
[CLS] what should a person be more afraid of ? a [MASK] or a ga ##tor ? [SEP]	shark	Q7372	dangerous
[CLS] is the blue [MASK] dog more expensive than the great dane or it ' s just the color of their fur ? [SEP]	dog	Q144	price
[CLS] is a rabbit faster than a [MASK] [SEP]	fox	Q8331	speed
[CLS] are u more afraid of [MASK] or giant cock ##ro ##ache ##s ? [SEP]	spiders	Q1357	dangerous
[CLS] are [MASK] or bet ##ta easier to take care of ? [SEP]	goldfish	Q123141	other
[CLS] da ##uch ##sund or york ##ie a more loving [MASK] [SEP]	lap dog	Q38914	friendliness
[CLS] which hears better a rabbit or [MASK] [SEP]	dog	Q144	hearing
[CLS] w ##hic ones cute ##r yellow [MASK] or bea ##gle ? [SEP]	beagle	Q21102	cute
[CLS] what smells worse 2 male [MASK] or 1 male ham ##ster ? [SEP]	Rats	Q36396	smelly
[CLS] which animal do you like more ? wolves or [MASK] [SEP]	Foxes	Q8331	other
[CLS] is the average squirrel faster than the average [MASK] [SEP]	human	Q15978631	speed
[CLS] what do you think is smarter . [MASK] or cats ? [SEP]	Dogs	Q144	intelligence
[CLS] the great debate : [MASK] or pup ##pies ? which is cute ##r ? [SEP]	kittens	Q147	cute
[CLS] the great debate : kitten ##s or [MASK] which is cute ##r ? [SEP]	kittens	Q147	cute
[CLS] what is cute ##r a [MASK] or a squirrel in your op ##ino ##in ? [SEP]	chipmunk	Q85752125	cute
[CLS] do [MASK] live longer than humans ? [SEP]	dogs	Q144	lifespan
[CLS] what pet is cheaper ? a [MASK] or a fe ##rret ? [SEP]	ferret	Q178973	price
[CLS] which is faster a cat or a [MASK] [SEP]	dog	Q144	speed
[CLS] what has better looking legs , a sea ##gul ##l or a [MASK] [SEP]	chicken	Q780	other
[CLS] are lion cubs or [MASK] cubs cute ##r ? [SEP]	tiger	Q19939	cute
[CLS] what is a better pet for a child , a dwarf ham ##ster or a [MASK] [SEP]	mouse	Q2751034	other
[CLS] are [MASK] mouths really cleaner than humans ' ? [SEP]	dogs	Q144	clean
[CLS] why sea animals live longer than land animals including [MASK] [SEP]	humans	Q15978631	lifespan
[CLS] do mice or [MASK] smell worse ? [SEP]	guinea pigs	Q79803	smelly
[CLS] whose fore ##pa ##w sw ##ipe is more stronger or powerful is it adult male [MASK] or adult siberian tiger ? [SEP]	lion	Q140	strength
[CLS] which can run faster ? a [MASK] or a dog ? [SEP]	cat	Q146	speed
[CLS] wat ##s cute ##r pup ##pies or [MASK] lu ##v ya than ##x ? [SEP]	kittens	Q147	cute
[CLS] what smells better a rabbit or [MASK] [SEP]	chinchilla	Q192930	smelly
[CLS] what is cute ##r a [MASK] or a duck ? [SEP]	rabbit	Q9394	cute
[CLS] which is better a dwarf ham ##ster or a teddy [MASK] ham ##ster ? [SEP]	bear	Q11788	other
[CLS] are cats typically smarter than [MASK] [SEP]	dogs	Q144	intelligence
[CLS] which has a cleaner mouth a camel or [MASK] [SEP]	dog	Q144	smelly
[CLS] are cats faster than [MASK] if not , what should i do ? [SEP]	raccoons	Q121439	speed
[CLS] dogs age 7 times faster than [MASK] i think this is false . ? [SEP]	humans	Q15978631	speed
[CLS] wolf pack vs [MASK] pack , which one is more fascinating ? [SEP]	Lion	Q140	other
[CLS] more misunderstood species : [MASK] or wolf ? [SEP]	bear	Q11788	other
[CLS] is it true the full grown male siberian tiger is stronger in strength than the full grown [MASK] [SEP]	african lion	Q140	strength
[CLS] which one is more expensive to own , 2 [MASK] or 2 mice ? [SEP]	rats	Q36396	price
[CLS] why do [MASK] age so much faster than humans ? [SEP]	dogs	Q144	lifespan
[CLS] cute ##r : [MASK] or cats ? [SEP]	dogs	Q144	cute
[CLS] which is more poisonous black widow or [MASK] [SEP]	tarantula	Q213383	other
[CLS] is [MASK] faster than quarter horses ? [SEP]	TWH	Q1708738	speed
[CLS] what is more expensive , a himalayan cat , or a [MASK] [SEP]	Persian cat	Q42610	price
[CLS] which dog is better border col ##lie or [MASK] ? [SEP]	american eskimo	Q37699	other
[CLS] who ' s mouth is cleaner a [MASK] or humans ? [SEP]	cats	Q146	clean
[CLS] which is better os x [MASK] or snow leopard ? [SEP]	Lion	Q140	other
[CLS] how is a [MASK] mouth cleaner than a humans ? [SEP]	dogs	Q144	clean
[CLS] why do dogs age so much faster than [MASK] [SEP]	humans	Q15978631	lifespan
[CLS] full grown male am ##ur tiger vs full grown male [MASK] who stronger or more powerful in fore ##leg ##s ? [SEP]	african lion	Q140	strength
[CLS] which is more dangerous , a wolf ##dog or a [MASK] [SEP]	pitbull	Q1144318	dangerous
[CLS] are pu ##gs better than any other [MASK] [SEP]	dogs	Q144	other
[CLS] why are [MASK] stronger than humans ? [SEP]	bears	Q11788	strength
[CLS] which smells worse ? dogs or [MASK] [SEP]	cats	Q146	smelly
[CLS] how much stronger is a [MASK] than an average human ? [SEP]	Kodiak Bear	Q237260	strength
[CLS] dwarf ham ##ster vs [MASK] which is the better one to get ? [SEP]	Syrian hamster	Q204175	other
[CLS] are pe ##di ##gree [MASK] more or less expensive than pe ##di ##gree dogs ? [SEP]	cats	Q146	price
[CLS] which r cute ##r [MASK] or sha ##r pei ? [SEP]	basset hounds	Q37716	cute
[CLS] how much stronger are gorilla ##s as compared to [MASK] [SEP]	gorillas	Q36611	strength
[CLS] which is faster a cat or a [MASK] [SEP]	rabbit	Q9394	speed
[CLS] which animal is slower : a turtle or a [MASK] [SEP]	Sloth	Q2274076	speed
[CLS] who ' s mouth is cleaner a [MASK] or a cat ? [SEP]	dog	Q144	clean
[CLS] [MASK] vs york ##ie ? cute ##r ? [SEP]	Maltese	Q38751	cute
[CLS] are [MASK] or cats smarter ? [SEP]	dogs	Q144	intelligence
[CLS] what is more dangerous to people - a [MASK] or a che ##eta ##h ? [SEP]	cheetah	Q23907	dangerous
[CLS] what ' s bigger - a wasp or a [MASK] [SEP]	bee	Q7391	size
[CLS] are dogs more expensive to take care of than [MASK] [SEP]	cats	Q146	price
[CLS] what is smarter [MASK] or mac ##aw ? [SEP]	parrot	Q31431	intelligence
[CLS] is a german shepherd more ag ##gre ##sive than a [MASK] [SEP]	pitbull	Q1144318	dangerous
[CLS] what is smarter , a [MASK] or a cat ? [SEP]	DOG	Q144	intelligence
[CLS] what ham ##ster bites more . a [MASK] ( big ham ##ster ) or dwarf ham ##ster ( small ham ##ster ) ? ? [SEP]	Syrian hamster	Q204175	other
[CLS] does this look right ? is a [MASK] mouth really cleaner than a human ' s ? how to count bacteria ? [SEP]	dogs	Q144	clean
[CLS] [MASK] & english bull terri ##er which one is easier to train and groom ? [SEP]	Beagle	Q21102	other
[CLS] which smells worse : dogs or [MASK] [SEP]	cats	Q146	smelly
[CLS] i really want to know about which is cleaner . is it a [MASK] mouth or a cat ' s ? [SEP]	dog's	Q144	clean
[CLS] why do [MASK] live longer than dogs ? [SEP]	cats	Q146	lifespan
[CLS] who shed less pu ##g or [MASK] [SEP]	Havanese	Q38449	other
[CLS] what do you think is cute ##r a [MASK] or a flying squirrel ? ! ? [SEP]	rabbit	Q9394	cute
[CLS] which is stronger the [MASK] or the elephant ? [SEP]	bear	Q11788	strength
[CLS] static ##ally , why do pit ##bu ##lls attack more than [MASK] [SEP]	Labs	Q38726	other
[CLS] what animal kills more people per year : [MASK] or hip ##po ##s ? [SEP]	Sharks	Q7372	deadly
[CLS] which ham ##ster is better [MASK] or rob ##o dwarf ham ##ster ? [SEP]	syrian hamster	Q204175	other
[CLS] what are cute ##r [MASK] or kitten ##s ? [SEP]	hamsters	Q6573	cute
[CLS] which animal is stronger ? the [MASK] or the gorilla ? [SEP]	Tiger	Q19939	strength
[CLS] are male [MASK] cats cute ##r or better looking than females ? [SEP]	kittens	Q147	cute
[CLS] a blue whale ' s tongue weighs more than an [MASK] . . is that true ? [SEP]	elephant	Q7378	mass
[CLS] why have sea turtles always lived longer than [MASK] can ? [SEP]	humans	Q15978631	other
[CLS] which is cute ##r ? ? a york ##ie or a [MASK] ? [SEP]	Dachshund	Q29099	cute
[CLS] how are [MASK] mouths cleaner than humans ? [SEP]	dogs	Q144	clean
[CLS] why do pit bull owners feel pit bulls should have more rights to safety than [MASK] should to safety ? [SEP]	humans	Q15978631	other
[CLS] which is better to have a [MASK] or a dwarf ham ##ster ? [SEP]	guinea pig	Q79803	other
[CLS] [MASK] vs ti ##gon : which one is stronger ? [SEP]	Liger	Q182573	strength
[CLS] what is friend ##lier to people , [MASK] or al ##pac ##as ? [SEP]	llamas	Q42569	friendliness
[CLS] can dogs run faster than [MASK] [SEP]	humans	Q15978631	speed
[CLS] which animal is faster , a [MASK] or a house cat ? [SEP]	rabbit	Q9394	speed
[CLS] what is bigger a male li ##ger or a male [MASK] [SEP]	siberian tiger	Q69581	size
[CLS] poll . . . . are cats smarter than [MASK] [SEP]	dogs	Q144	intelligence
[CLS] would a [MASK] be ok with older border col ##lies ? [SEP]	lab	Q38726	other
[CLS] which is smarter ? a [MASK] or a german shepherd ? [SEP]	Siberian husky	Q39295	intelligence
[CLS] which animal is smarter : the cat or the [MASK] [SEP]	dog	Q144	intelligence
[CLS] survey ~ what is cute ##r . . [MASK] or kitten ##s ? [SEP]	Kittens	Q147	cute
[CLS] are [MASK] to ##ung ##es actually cleaner then humans ? [SEP]	Dogs	Q144	clean
[CLS] what is smarter a [MASK] or a great white shark ? and tell me why ? [SEP]	saltwater crocodile	Q182599	intelligence
[CLS] why are their more black ##birds than [MASK] [SEP]	hawks	Q846664	other
[CLS] which animal is cute ##r ( in this case ) ? cat or [MASK] [SEP]	rabbit	Q9394	cute
[CLS] is a [MASK] or a maltese more expensive ? [SEP]	SHIH TZU	Q39357	price
[CLS] what ' s better as a pet [MASK] or lizard ? [SEP]	Bird	Q5113	other
[CLS] [MASK] vs sperm whale : which is more intelligent ? [SEP]	KILLER WHALE	Q26843	intelligence
[CLS] which can swim faster ? a [MASK] or a crab ? [SEP]	croc	Q2535664	swimmingspeed
[CLS] what are cute ##r ham ##sters or [MASK] [SEP]	hamsters	Q6573	cute
[CLS] do red bet ##ta fish get their fish bowls dirty faster then blue bet ##ta ' s ? [SEP]	blue betta	Q1090773	other
[CLS] what is bigger a fox or a [MASK] [SEP]	badger	Q638105	size
[CLS] does a [MASK] swim faster than a turtle ? [SEP]	frog	Q53636	speed
[CLS] are cats cleaner then [MASK] [SEP]	humans	Q15978631	clean
[CLS] what animal is statistical ##ly smarter a [MASK] or a turtle ? [SEP]	rabbit	Q9394	intelligence
[CLS] whose bones are stronger ? a [MASK] or human ' s ? [SEP]	dog's	Q144	strength
[CLS] when it comes to vet bills , are fe ##rret ##s more expensive than [MASK] [SEP]	ferrets	Q178973	price
[CLS] why is pink salmon cheaper than [MASK] [SEP]	Red Salmon	Q44064	price
[CLS] so , who ' s smarter : cats or [MASK] [SEP]	dogs	Q144	intelligence
[CLS] generally speaking , what are more affection ##ate , [MASK] or guinea pigs ? [SEP]	rabbits	Q9394	friendliness
[CLS] which dog is cute ##r - a [MASK] or golden retrieve ##r ? [SEP]	Golden Retriever	Q38686	cute
[CLS] do rabbits smell worse than [MASK] [SEP]	ferrets	Q178973	smelly
[CLS] do [MASK] is stronger or t - rex ? [SEP]	spinosaurus	Q130966	strength
[CLS] what runs faster ? a hip ##po or a [MASK] [SEP]	hippo	Q34505	speed
[CLS] are rabbits cleaner than [MASK] [SEP]	guinea pigs	Q79803	clean
[CLS] walking in the woods , which is scar ##ier ? a coward ##ly [MASK] a big bad wolf , or a guy beating two coconut ##s together ? [SEP]	lion	Q140	other
[CLS] are chickens smarter than [MASK] [SEP]	dogs	Q144	intelligence
[CLS] is there a dog like the [MASK] but smaller than it but bigger than the shi ##ba in ##u ? [SEP]	Akita	Q29164	size
[CLS] [MASK] vs . rabbit ; which one ' s smarter ? [SEP]	Guinea pig	Q79803	intelligence
[CLS] who can run faster a [MASK] or a dog ? [SEP]	cat	Q146	speed
[CLS] is a [MASK] mouth really cleaner than a humans ? [SEP]	dog's	Q144	clean
[CLS] is it true that a [MASK] mouth is cleaner than a humans ? > ? [SEP]	dogs	Q144	clean
[CLS] male [MASK] vs male spotted h ##yen ##a who is more stronger in strength and who will win in one on one fight ? [SEP]	leopard	Q34706	strength
[CLS] what smells worse a [MASK] or bunny ? [SEP]	guinea pig	Q79803	smelly
[CLS] did you know that [MASK] can last without water longer than a camel ? [SEP]	rats	Q36396	length
[CLS] my boyfriend wants a [MASK] he likes big dogs . which dog is better a pit bull or german sha ##par ##d . ? [SEP]	pit bull	Q1144318	other
[CLS] what ' s cute ##r , pup ##pies or [MASK] [SEP]	kittens	Q147	cute
[CLS] which is more developed earth ##worm or [MASK] on the basis of anatomy and morphology ? [SEP]	frog	Q53636	other
[CLS] what is cute ##r a ham ##ster or a [MASK] [SEP]	guinea pig	Q79803	cute
[CLS] are [MASK] mean ##er than pit ##bu ##lls cause a chow bit me yesterday ? ? ? ! ! ! ! ? [SEP]	chows	Q29013	mean
[CLS] can a dog run faster than a [MASK] [SEP]	human	Q15978631	speed
[CLS] is a [MASK] mouth cleaner to itself then a humans mouth would be to another human ? [SEP]	dogs	Q144	clean
[CLS] which is better a rob ##oro ##vs ##ki ham ##ster or a [MASK] [SEP]	winter white hamster	Q214633	other
[CLS] [MASK] stronger than gorilla ##s ? [SEP]	Orangutans	Q41050	strength
[CLS] how many times more deadly is a lion than a [MASK] and is this difference significant ? [SEP]	Wolf	Q18498	deadly
[CLS] cute ##r : baby , [MASK] or kitten ? [SEP]	Puppy	Q39266	cute
[CLS] are [MASK] or humans stronger ? [SEP]	dogs	Q144	strength
[CLS] do ham ##sters smell worse or [MASK] [SEP]	guinea pigs	Q79803	smelly
[CLS] witch is faster hip ##po or [MASK] [SEP]	elephant	Q7378	speed
[CLS] what lizards / [MASK] can live in a 40 gallon breed ##er or smaller as adults and i would also like to be able to handle it ? [SEP]	snakes	Q2102	other
[CLS] w ##hic ones cute ##r yellow lab or [MASK] [SEP]	beagle	Q21102	cute
[CLS] are [MASK] mouths cleaner than humans ? [SEP]	dog's	Q144	clean
[CLS] are cats cleaner than [MASK] [SEP]	dogs	Q144	clean
[CLS] what ##s better [MASK] or lizard ? [SEP]	snake	Q2102	other
[CLS] which is smarter ; a [MASK] or a german shepherd ? [SEP]	grey wolf	Q18498	intelligence
[CLS] what ##s a stronger and more fr ##end ##ly dog a [MASK] or a pit ##bu ##ll ? [SEP]	boxer	Q38496	other
[CLS] which is smarter , a [MASK] or a por ##po ##ise ? [SEP]	dophin	Q7369	intelligence
[CLS] which is more intelligent [MASK] or cats ? [SEP]	DOGS	Q144	intelligence
[CLS] w ##w ##ho is stronger gorilla or [MASK] [SEP]	orangutan	Q41050	strength
[CLS] which is more dangerous a [MASK] or alligator ? [SEP]	crocodile	Q2535664	dangerous
[CLS] who is the cute ##r , nice ##r and lo ##vable [MASK] or chow chow ? [SEP]	pomeranian	Q39579	cute
[CLS] what is cute ##r - a baby [MASK] or a kitten ? [SEP]	fox	Q8331	cute
[CLS] what smells better a [MASK] or chin ##chi ##lla ? [SEP]	chinchilla	Q192930	smelly
[CLS] are german shepard ' s smarter than [MASK] [SEP]	Rottweilers	Q39093	intelligence
[CLS] is it true that a [MASK] mouth is cleaner than a humans mouth ? ? [SEP]	dog's	Q144	clean
[CLS] are [MASK] more dangerous than a mouse is ? [SEP]	rats	Q36396	dangerous
[CLS] what ##s better [MASK] or pit ##bu ##ll ? [SEP]	american bulldog	Q37604	other
[CLS] why does [MASK] cost more than pink salmon ? [SEP]	red salmon	Q44064	price
[CLS] who is smarter : cats or [MASK] [SEP]	dogs	Q144	intelligence
[CLS] what is cleaner and more h ##y ##gie ##nic , a rabbit or a [MASK] [SEP]	cat	Q146	clean
[CLS] border col ##lie or [MASK] which would shed more thru ##out the year , which do you like better ? [SEP]	aussie	Q37629	other
[CLS] which is stronger a black bear or a [MASK] [SEP]	lion	Q140	strength
[CLS] which are cute ##r : baby [MASK] or baby kitten ##s ? [SEP]	Kittens	Q147	cute
[CLS] which animal can hear better the [MASK] or the dog ? [SEP]	cat	Q146	hearing
[CLS] about how much stronger is a [MASK] than a man ? [SEP]	chimpanzee	Q4126704	strength
[CLS] who ##s faster ? ( [MASK] or rabbit ) ? [SEP]	turtle	Q223044	speed
[CLS] what ' s fun ##nier . . . . a roller ##ska ##ting [MASK] or a water skiing squirrel ? [SEP]	monkey	Q1367	other
[CLS] if [MASK] can run faster than chicken , then why is so hard to catch a chicken ? [SEP]	human	Q15978631	speed
[CLS] what ' s cute ##r ham ##ster or [MASK] [SEP]	gerbil	Q244770	cute
[CLS] which pets are smarter : cats or [MASK] [SEP]	dogs	Q144	intelligence
[CLS] [MASK] mouth cleaner than humans - theory ? [SEP]	Dogs	Q144	clean
[CLS] should i get a [MASK] or a ham ##ster ? and which is cleaner ? [SEP]	guinea pig	Q79803	clean
[CLS] is it true that dogs have cleaner mouths than [MASK] [SEP]	humans	Q15978631	smelly
[CLS] which pet would be easier to start with ? lizard or [MASK] [SEP]	rat	Q36396	other
[CLS] cats or [MASK] which is cute ##r ? [SEP]	bunnies	Q9394	cute
[CLS] what ##s faster border col ##lie or [MASK] [SEP]	German Shepherd	Q38280	other
[CLS] are bet ##ta fish better than [MASK] [SEP]	Guppies	Q178202	other
[CLS] what are better [MASK] or border col ##lie ? [SEP]	Bernese Mountain dogs	Q37608	other
[CLS] which is cute ##r , a puppy or a [MASK] [SEP]	kitten	Q147	cute
[CLS] which is faster : the [MASK] or the rabbit ? [SEP]	hare	Q46076	speed
[CLS] which are more cute : squirrels or [MASK] [SEP]	chipmunks	Q85752125	other
[CLS] which dog is more affection ##ate a weimar ##ane ##r or a [MASK] [SEP]	dalmatian	Q17504	friendliness
[CLS] who are smarter cats or [MASK] [SEP]	dogs	Q144	intelligence
[CLS] which is bigger a mammoth or a [MASK] [SEP]	Whale	Q1865281	size
[CLS] is it true that pit ##bu ##ll [MASK] we ##an earlier than most pup ##pies ? [SEP]	puppies	Q39266	other
[CLS] do [MASK] hear better than humans ? [SEP]	birds	Q5113	hearing
[CLS] are [MASK] stronger than h ##yen ##a ' s and why ? [SEP]	lions	Q140	strength
[CLS] are [MASK] mouths cleaner than humans ' mouths ? [SEP]	dogs	Q144	clean
[CLS] which weighs more , an os ##tric ##h or an [MASK] [SEP]	ostrich	Q17592	mass
[CLS] what is cute ##r ? a [MASK] or a cat ? [SEP]	dog	Q144	cute
[CLS] poll : witch is faster ? turtle or [MASK] ? [SEP]	rabbit	Q9394	speed
[CLS] which pet is cute ##r ? cats or [MASK] [SEP]	Dogs	Q144	cute
[CLS] who ##s faster ? ( turtle or [MASK] ? [SEP]	rabbit	Q9394	speed
[CLS] why is a [MASK] mouth cleaner than a human ' s ? [SEP]	dog's	Q144	clean
[CLS] what ##s bigger , an otter or a [MASK] ? [SEP]	beaver	Q47542	size
[CLS] is a cat ' s mouth cleaner than a [MASK] s ? [SEP]	cat's	Q146	clean
[CLS] which is faster a [MASK] or a rabbit ? [SEP]	cat	Q146	speed
[CLS] do you think gaze ##lles will evolve to run faster than [MASK] since they have more necessity to be faster to survive ? [SEP]	Cheetahs	Q23907	other
[CLS] ultimate poll question # 1 which is cute ##r . . [MASK] or kitten ##s . . . go ! ? [SEP]	Kittens	Q147	cute
[CLS] why is it more expensive to ship a dog than a [MASK] [SEP]	human	Q15978631	price
[CLS] are you more afraid of a sting ##ray or a [MASK] [SEP]	Shark	Q7372	dangerous
[CLS] is it true [MASK] tongues are cleaner than humans . . . . . . . . . ? [SEP]	dog's	Q144	clean
[CLS] [MASK] tongues are cleaner than humans tongues ? 10 points ! ? [SEP]	Dogs	Q144	clean
[CLS] which spider is more deadly a [MASK] or a black widow ? [SEP]	brown reculse	Q284352	deadly
[CLS] are squirrels easier to train than [MASK] [SEP]	dogs	Q144	other
[CLS] are [MASK] clever ##er than cats ? [SEP]	dogs	Q144	intelligence
[CLS] which is better , a border col ##lie or [MASK] [SEP]	australian shepherd	Q37629	other
[CLS] is a bet ##ta better than a [MASK] [SEP]	goldfish	Q123141	other
[CLS] do dogs have cleaner mouths than [MASK] [SEP]	humans	Q15978631	smelly
[CLS] which is cheaper to take care of , a dog or a [MASK] [SEP]	cat	Q146	price
[CLS] which is more dangerous , dogs to eat [MASK] food or cats eating dog food ? [SEP]	dogs	Q144	dangerous
[CLS] which is more dangerous , an alligator or a [MASK] please give sources . thanks . . . ? [SEP]	crocodile	Q2535664	dangerous
[CLS] is human life cheaper than that of [MASK] [SEP]	Dogs	Q144	price
[CLS] wat ##s cute ##r kitten ##s or [MASK] [SEP]	kittens	Q147	cute
[CLS] who can hear better , dogs or [MASK] [SEP]	cats	Q146	hearing
[CLS] which is more intelligent , a cat or a [MASK] [SEP]	dog	Q144	intelligence
[CLS] what stink ##s worse , dog , child , adult or [MASK] . . . . . ? ? ? [SEP]	cat	Q146	smelly
[CLS] are chi ##mp ##an ##zee ##s stronger than most world stronger [MASK] competitors ? [SEP]	chimpanzees	Q4126704	strength
[CLS] did [MASK] live longer than humans ? [SEP]	dinosaurs	Q430	lifespan
[CLS] which is taller at the shoulder , [MASK] or siberian tiger ? [SEP]	African lion	Q140	height
[CLS] are guinea pigs or [MASK] more expensive to keep ? [SEP]	rats	Q36396	price
[CLS] do you like [MASK] or crows better ? [SEP]	SEAGULLS	Q3112866	other
[CLS] would a [MASK] or golden retrieve ##r be more loving ? [SEP]	german shephard	Q38280	friendliness
[CLS] which one is cute ##r [MASK] or labrador retrieve ##r ? [SEP]	golden retriever	Q38686	cute
[CLS] should i get a pit ##bu ##ll or [MASK] which is more friendly and overall better dog ? [SEP]	Chihuahua	Q653	other
[CLS] is it easier to breed bet ##ta fish or regular [MASK] [SEP]	gold fish	Q123141	other
[CLS] wat ##s cute ##r [MASK] or kitten ##s ? lu ##v ya than ##x ? [SEP]	kittens	Q147	cute
[CLS] why are people more afraid of roach ##es than they are of [MASK] [SEP]	spiders	Q1357	dangerous
[CLS] which is smarter a [MASK] or a guinea pig ? [SEP]	rat	Q36396	intelligence
[CLS] poll : are [MASK] stronger than humans ? [SEP]	dogs	Q144	strength
[CLS] which one is more expensive to own , 2 rats , or 2 [MASK] [SEP]	mice	Q2751034	price
[CLS] which is smarter a deer or a [MASK] [SEP]	coyote	Q44299	intelligence
[CLS] is that true pigs are more intelligent than [MASK] [SEP]	dogs	Q144	intelligence
[CLS] which [MASK] is more expensive a german shepherd or a german she ##pr ##ador ? how much difference is between ? [SEP]	puppy	Q39266	price
[CLS] why do humans live longer than [MASK] [SEP]	dogs	Q144	lifespan
[CLS] rob ##oro ##vs ##ki [MASK] . . which ones get bigger ? male or female ? [SEP]	dwarf hamsters	Q738140	other
[CLS] survey : what ' s cute ##r ? a cat or a [MASK] in a santa hat ? [SEP]	Dog	Q144	cute
[CLS] which is smarter [MASK] or german shepherd ? [SEP]	border collie	Q37710	intelligence
[CLS] which species are cute ##r , [MASK] or turtles ? [SEP]	ducks	Q3736439	cute
[CLS] what smells worse : dead fish or [MASK] po ##op ? [SEP]	dog	Q144	smelly
[CLS] why is it cheaper to use sheep in an experiment rather than [MASK] [SEP]	humans	Q15978631	price
[CLS] which animals are cleaner , rabbits or [MASK] which & why ? when i say cleaner , which smell less ? why ? [SEP]	cats	Q146	clean
[CLS] why can [MASK] hear better than humans ? [SEP]	dogs	Q144	hearing
[CLS] which are cleaner cats or [MASK] [SEP]	dogs	Q144	clean
[CLS] which is smarter a husky or a [MASK] [SEP]	Boxer	Q38496	intelligence
[CLS] which is smarter a [MASK] or a coyote ? [SEP]	deer	Q23390	intelligence
[CLS] pu ##g or [MASK] which is the better breed and why ? [SEP]	Lhasa apso	Q38352	other
[CLS] do [MASK] have super ##sonic hearing or better hearing than humans ? [SEP]	hamsters	Q6573	hearing
[CLS] are you more scared of [MASK] or mice ? [SEP]	frogs	Q53636	dangerous
[CLS] what makes a better pet dwarf ham ##ster or a [MASK] [SEP]	gerbil	Q244770	other
[CLS] why are cats smarter than [MASK] [SEP]	dogs	Q144	intelligence
[CLS] what smells worse ? dog fe ##ces or [MASK] fe ##ces ? [SEP]	Cat	Q146	smelly
[CLS] what is cute ##r , baby gi ##raf ##fe ##s or baby [MASK] [SEP]	giraffes	Q862089	cute
[CLS] which dog breed is cute ##r ? a [MASK] or yorkshire terri ##or ? [SEP]	pomeranian	Q39579	cute
[CLS] can a [MASK] run faster than leopard ? [SEP]	man	Q15978631	speed
[CLS] why are pit ##bu ##lls targeted more than [MASK] [SEP]	German shepherds	Q38280	other
[CLS] which ham ##ster is a better pet ? a [MASK] or a dwarf ham ##ster ? [SEP]	syrian hamster	Q204175	other
[CLS] why are pup ##pies so much cute ##r than [MASK] babies ? [SEP]	human	Q15978631	cute
[CLS] are pigs smarter than [MASK] [SEP]	dogs	Q144	intelligence
[CLS] how is a [MASK] 3 ##x stronger than a man ? [SEP]	chimpanzee	Q4126704	strength
[CLS] are pu ##ggles good pets or would a regular pu ##g be better . i ' m afraid the pu ##ggle might howl , or bark too much [SEP]	puggles	Q2620608	other
[CLS] which is better [MASK] or chinese ham ##ster ? [SEP]	syrian hamsters	Q204175	other
[CLS] poll : which is cute ##r , pup ##pies , [MASK] or babies ? [SEP]	kitties	Q147	cute
[CLS] what ##s a better [MASK] pu ##g * * * * - sue or mini lab ##od ##ore ? [SEP]	dog	Q144	other
[CLS] are cats smarter than [MASK] or dogs smarter than cats ? [SEP]	cats	Q146	intelligence
[CLS] are lions really taller than [MASK] at the shoulder ? [SEP]	tigers	Q19939	height
[CLS] what is cute ##r , baby [MASK] or baby turtles ? [SEP]	giraffes	Q862089	cute
[CLS] which animal is smarter , a [MASK] or a rap ##tor ? [SEP]	dolphin	Q7369	intelligence
[CLS] which can run faster - a chicken or a [MASK] [SEP]	penguin	Q9147	speed
[CLS] are cats or [MASK] smarter ? [SEP]	dogs	Q144	intelligence
[CLS] can [MASK] hear better than dogs ? [SEP]	elephants	Q7378	hearing
[CLS] can bull terri ##ers co exist with [MASK] if introduced at a younger age ? [SEP]	cats	Q146	other
[CLS] is there a bigger version of a cavalier [MASK] which is called a king charles span ##iel ? [SEP]	Cavalier King Charles	Q38072	other
[CLS] who ' s mouth is cleaner a cats or [MASK] [SEP]	humans	Q15978631	clean
[CLS] which is cute ##r ? kitten or [MASK] [SEP]	puppy	Q39266	cute
[CLS] why are the cells of a huge elephant not longer than y ##he cells of a [MASK] [SEP]	cat	Q146	length
[CLS] are [MASK] cleaner then humans ? [SEP]	cats	Q146	clean
[CLS] is a [MASK] still stronger than the strongest human male ever ? stronger than a human male with the world ? [SEP]	Chimpanzee	Q4126704	strength
[CLS] what is more dangerous , a che ##eta ##h or a [MASK] [SEP]	lion	Q140	dangerous
[CLS] are [MASK] really smarter than cats ? [SEP]	dogs	Q144	intelligence
[CLS] [MASK] vs lizard : which is better ? [SEP]	Tarantula	Q213383	other
[CLS] is a chihuahua more vicious than a [MASK] [SEP]	doberman	Q38358	mean
[CLS] what is the behaviour ##al repertoire of a wolf , or more specifically a [MASK] ? [SEP]	dog	Q144	other
[CLS] why do [MASK] cost less to take care of than dogs ? [SEP]	cats	Q146	price
[CLS] which animal is faster : the [MASK] or the toad ? [SEP]	frog	Q53636	speed
[CLS] baby humans or baby [MASK] ? ? ? ? ? which is cute ##r ? [SEP]	CATS	Q146	cute
[CLS] which is cute ##r ? ? a [MASK] or a da ##chs ##hun ##d . ? [SEP]	Dachshund	Q29099	cute
[CLS] which animal hide is stronger : elephant or [MASK] [SEP]	rhino	Q34718	strength
[CLS] are [MASK] cleaner than ham ##sters . ? [SEP]	rats	Q36396	clean
[CLS] what is more expensive keeping a fish tank or a [MASK] lizard ? [SEP]	anole	Q930252	price
[CLS] why is it more expensive to ship a [MASK] than a human ? [SEP]	dog	Q144	price
[CLS] are [MASK] mouths really cleaner then humans ? [SEP]	dogs	Q144	clean