Question	Masked text span	Wikidata id	Conjectured property
[CLS] did you notice in the past 2 years iv ##e been trying to say [MASK] is better than kobe . . . . ? [SEP]	Lebron	Q36159	better
[CLS] which team is better : [MASK] less ca ##vs or dwight howard - less magic ? [SEP]	Lebron	Q36159	better
[CLS] buy or sell : kobe is better than [MASK] overall , but le ##bron is better than kobe defensive ##ly ? [SEP]	LeBron	Q36159	better
[CLS] kobe or [MASK] who had more impact on their team ' s success when they came to the nba ? [SEP]	Jordan	Q41421	other
[CLS] who is better : dwight howard or [MASK] [SEP]	Chris Bosh	Q201386	better
[CLS] who has more mvp ##s [MASK] or steve nash ? [SEP]	kobe bryant	Q25369	other
[CLS] who do you think is better [MASK] or kobe bryant ? read below ? [SEP]	Dirk Nowitzki	Q44068	better
[CLS] [MASK] is the goat , but kobe is a better scorer , and here is why . . ? [SEP]	MJ	Q41421	shooting
[CLS] who is stronger and buffer ? [MASK] or kobe bryant ? [SEP]	Lebron James	Q36159	strength
[CLS] who has more ring [MASK] or steve nash ? [SEP]	Eddy Curry	Q446513	other
[CLS] who ##s better , paul pierce or [MASK] [SEP]	vince carter	Q241261	better
[CLS] will [MASK] end up being a bigger bust than dark ##o mil ##ici ##c ? [SEP]	Darko Milicic	Q316256	other
[CLS] true or false , wade has more finals mvp than kobe and [MASK] combined ? [SEP]	LeBron	Q36159	other
[CLS] who is better and why . . [MASK] or dwight howard ? [SEP]	Carmelo Anthony	Q129041	better
[CLS] do you think kobe bryant is better than [MASK] [SEP]	lebron james	Q36159	better
[CLS] who is faster : [MASK] or lean ##dro bar ##bos ##a ? [SEP]	Monta Ellis	Q381746	athletic
[CLS] who thinks steve nash is better than [MASK] [SEP]	Rondo	Q274469	better
[CLS] will dwight howard be better in his carrier then [MASK] [SEP]	Shaq	Q169452	better
[CLS] do people realize that [MASK] is better than kobe at shooting ? [SEP]	Nowitzki	Q44068	shooting
[CLS] we know [MASK] is better than kobe in basketball , is sha ##q better than kobe in rap ##ping ? [SEP]	SHAQ	Q169452	better
[CLS] is kobe a better closer then [MASK] [SEP]	Air Jordan	Q41421	other
[CLS] who ' s more over ##rated , steve nash or [MASK] [SEP]	Kobe Bryant	Q25369	popularity
[CLS] which player is more dominant ? kobe or [MASK] [SEP]	Lebron	Q36159	importance
[CLS] hasn ##t [MASK] had a more successful career than steve nash ? [SEP]	DJ Mbenga	Q381762	other
[CLS] who was better . . . [MASK] or mark price ? [SEP]	Kenny Anderson	Q1280005	better
[CLS] who is more over ##rated ? bill russell or [MASK] [SEP]	Kobe Bryant	Q25369	popularity
[CLS] who ' s a better basketball player steve nash or [MASK] [SEP]	Kobe Bryant	Q25369	better
[CLS] who is more selfish : kobe bryant or [MASK] [SEP]	Stephon Marbury	Q319336	other
[CLS] who would be a better soccer player [MASK] or steve nash ? [SEP]	Kobe Bryant	Q25369	better
[CLS] whose tired of [MASK] fans saying he ##s better than kobe ? [SEP]	lebron	Q36159	better
[CLS] if kobe and [MASK] traded bodies , who would be better ? ? [SEP]	lebron	Q36159	other
[CLS] is kevin duran ##t a better scorer than [MASK] [SEP]	Lebron James	Q36159	shooting
[CLS] basketball fans - who do you think is going to be a better nba center - [MASK] or hash ##eem tha ##bee ##t ? [SEP]	Greg Oden	Q313487	other
[CLS] who have better ball handling skills , [MASK] or steve nash ? [SEP]	Rajon Rondo	Q274469	other
[CLS] who ' s better ? prime [MASK] or dwight howard ? [SEP]	Rasheed Wallace	Q270975	better
[CLS] who ' s better dwight howard or [MASK] [SEP]	Kevin Garnett	Q189240	better
[CLS] who will have a better season [MASK] or andrea bar ##gnan ##i ? [SEP]	Rudy Gay	Q370275	season
[CLS] i ' m so sick and tired of people saying kobe is better than [MASK] [SEP]	jordan	Q41421	better
[CLS] is kobe choking worse against the celtics than [MASK] did ? [SEP]	Lebron	Q36159	other
[CLS] who has / had a better jumps ##hot , kobe bryant or [MASK] [SEP]	Michael Jordan	Q41421	other
[CLS] why do some people think kobe is better than [MASK] when obviously he is not ? [SEP]	LeBron	Q36159	better
[CLS] who do you think was the better player , [MASK] or dominique wilkins ? why ? [SEP]	James Worthy	Q362872	better
[CLS] who is a better shot block ##er [MASK] or dwight howard ? [SEP]	Serge Ibaka	Q313389	defence
[CLS] according to facts , who is more clutch , kobe or [MASK] [SEP]	LeBron	Q36159	other
[CLS] last question : who has a bigger ego , kobe or [MASK] [SEP]	lebron	Q36159	other
[CLS] who is more clutch : [MASK] or derrick rose ? [SEP]	Jeremy Lin	Q309590	clutch
[CLS] who will have the better career from here on out ? [MASK] or paul george ? [SEP]	Kevin Durant	Q29545	career
[CLS] who ' s more clutch kobe or [MASK] [SEP]	jordan	Q41421	clutch
[CLS] who ##s the better ball player , [MASK] or kobe bryant ? [SEP]	allen iverson	Q190094	better
[CLS] who ' s a better shooter : prime kobe or [MASK] [SEP]	Kevin Durant	Q29545	shooting
[CLS] who is better paul pierce or [MASK] [SEP]	Chris Bosh	Q201386	better
[CLS] so now with kobe ' s 5th ring do [MASK] fans even have a case in saying le ##bron ##s better ? [SEP]	Lebron	Q36159	better
[CLS] who is a better player , [MASK] or rudy gay ? [SEP]	Luol Deng	Q275183	better
[CLS] have kobe only been more successful in playoffs than [MASK] because he has better help ? [SEP]	Lebron	Q36159	other
[CLS] who would make a better football player [MASK] kobe , dwight , or m ##j ? [SEP]	lebron	Q36159	other
[CLS] before [MASK] got injured was he better then dwight howard ? [SEP]	andrew bynum	Q314822	better
[CLS] whose better [MASK] or paul pierce ? [SEP]	Tracy McGrady	Q202295	better
[CLS] who has more money . . . . d ##way ##ne wade or [MASK] [SEP]	Kobe Bryant	Q25369	money
[CLS] doesn ' t it seem strange how nike promotes [MASK] more then kobe ? [SEP]	Lebron	Q36159	other
[CLS] is blake griffin a better dun ##ker than [MASK] ? [SEP]	Michael Jordan	Q41421	dunking
[CLS] who is a better basketball player : [MASK] ca ##vs ) , ron ##do ( celtics ) , or ellis ( warriors ) ? [SEP]	mo williams	Q352118	better
[CLS] who ' s better dwight howard or [MASK] [SEP]	Hakeem Olajuwon	Q273256	better
[CLS] why does og alpha ( king destroyer ) says that kobe is better then [MASK] [SEP]	Jordan	Q41421	better
[CLS] instead of asking who is better ( [MASK] vs kobe ) how about this ? [SEP]	Lebron	Q36159	better
[CLS] what ' s more impressive , kobe ' s 81 point game or [MASK] s 100 ? [SEP]	Wilt Chamberlain	Q182455	other
[CLS] does anyone else agree with me that trevor ari ##za is way better than [MASK] [SEP]	kobe bryant	Q25369	better
[CLS] who do you like more , [MASK] or kobe , why ? [SEP]	shaq	Q169452	other
[CLS] who ' s better , dwight howard or [MASK] [SEP]	David Robinson	Q211876	better
[CLS] who was a better player in their prime , kobe bryant or [MASK] [SEP]	Allen Iverson	Q190094	better
[CLS] who is a better basketball player [MASK] or kobe bryant ? [SEP]	Lebron James	Q36159	better
[CLS] who had a better supporting cast this past season , steve nash or [MASK] [SEP]	Kobe Bryant	Q25369	other
[CLS] who has the better nba career kobe bryant or [MASK] . . . i know kobe been in the league 16 y ##rs james 9 ##yr ##s ? [SEP]	Lebron James	Q36159	career
[CLS] are paul pierce jumping higher than [MASK] [SEP]	kobe	Q25369	other
[CLS] who was a better point guard in their prime derek fisher or [MASK] [SEP]	Nick Van Exel	Q558674	defence
[CLS] whose more under ##rated : lu ##ol deng or [MASK] [SEP]	Luol Deng	Q275183	popularity
[CLS] do you think [MASK] will be better than kobe or will even pass kobe ? [SEP]	lebron	Q36159	better
[CLS] who ' s more over ##rated , [MASK] or kobe bryant ? [SEP]	Steve Nash	Q192955	popularity
[CLS] who ' s a better player ; [MASK] or steve nash ? [SEP]	allen iverson	Q190094	better
[CLS] remember when rolling stones said [MASK] was better than kobe lo ##l ? [SEP]	Durant	Q29545	better
[CLS] who is better basketball player all around [MASK] or kobe ? [SEP]	Jordan	Q41421	better
[CLS] will le ##bron have a better career than [MASK] when they both retire ? [SEP]	Kobe	Q25369	career
[CLS] did kobe have better numbers against dallas than [MASK] is having even though they got swept ? [SEP]	lebron	Q36159	other
[CLS] why is 3 - year pro derrick rose already a better shooter than the 7 year pro [MASK] [SEP]	LEBRON JAMES	Q36159	shooting
[CLS] is it just me but why does devin harris look taller than [MASK] [SEP]	steven nash	Q192955	height
[CLS] in ur honest opinion who is a better basketball player : [MASK] or kobe bryant ? why ? [SEP]	Lebron Jame	Q36159	better
[CLS] who ' s taller , [MASK] or big ##sho ##w ? [SEP]	Shaq	Q169452	height
[CLS] was kobe bryant ' s 81 points more impressive than [MASK] s 100 ? [SEP]	Wilt Chamberlain	Q182455	other
[CLS] harder to defend [MASK] or prime kobe bryant ? [SEP]	LeBron James	Q36159	other
[CLS] who do you think is better for the magic , he ##do turk ##og ##lu or [MASK] [SEP]	Vince Carter	Q241261	better
[CLS] what was more impressive ? kobe ' s 61 or [MASK] s 52 ##pt triple - double ? [SEP]	Lebron	Q36159	other
[CLS] le ##bron or [MASK] . . who will have a better career ? [SEP]	Kobe	Q25369	career
[CLS] why do people call kobe old and not [MASK] is ##int duncan 3 years older ? [SEP]	Tim Duncan	Q193020	other
[CLS] who ' s a better basketball player [MASK] or kobe bryant ? [SEP]	Steve Nash	Q192955	better
[CLS] who is the better point guard j ##v cas ##io or ty tang ? [SEP]	JV Casio	Q6109166	defence
[CLS] who is more of a clutch shooter kobe bryant or [MASK] [SEP]	Gilbert Arenas	Q310108	other
[CLS] which puppet com ##meric ##al do you like better . . kobe vs [MASK] [SEP]	lebron	Q36159	better
[CLS] [MASK] vs ron ##do who ##s better ? [SEP]	Dwill	Q298496	better
[CLS] do you think [MASK] will have a better legacy than kobe ? [SEP]	Lebron	Q36159	other
[CLS] who is a better basketball player : raj ##on ron ##do or [MASK] [SEP]	monta ellis	Q381746	better
[CLS] who is a better dun ##ker blake griffin or [MASK] [SEP]	Dwight Howard	Q25278	dunking
[CLS] who ' s a better dun ##ker le ##bron or [MASK] [SEP]	Lebron	Q36159	dunking
[CLS] who do you think is better in the nba , steve nash or [MASK] [SEP]	jason kidd	Q221341	better
[CLS] who better jamal crawford or [MASK] [SEP]	Nate Robinson	Q315104	better
[CLS] who ' s more clutch [MASK] or paul pierce ? [SEP]	kobe	Q25369	clutch
[CLS] buy or sell : [MASK] is better than kobe bryant ? [SEP]	Kevin Durant	Q29545	better
[CLS] buy or sell : prime steve nash is a better pg than [MASK] [SEP]	Derrick Rose	Q205326	better
[CLS] who ' s a bigger ball - hog , kobe bryant or [MASK] [SEP]	Wilt Chamberlain	Q182455	other
[CLS] who will have a better career by estimation ? brandon roy or [MASK] [SEP]	Chris Paul	Q46040	career
[CLS] who is more of a pure point guard ? steve nash or [MASK] [SEP]	chris paul	Q46040	other
[CLS] who is a better overall player : carmel ##lo anthony or [MASK] [SEP]	Shawn Marion	Q311869	better
[CLS] who ' s better dem ##ar der ##oza ##n or [MASK] [SEP]	Paul George	Q973121	better
[CLS] who is better [MASK] or bill russ ##el ? [SEP]	michael jordan	Q41421	better
[CLS] does [MASK] kobe and howard fit better than the heats big 3 ? [SEP]	Steve Nash	Q192955	athletic
[CLS] at this stage of their careers , is [MASK] a better overall player than kobe ? [SEP]	D-wade	Q31683	better
[CLS] who ' s better , [MASK] or paul pierce ? [SEP]	Hedo Turkoglu	Q298981	better
[CLS] why are people saying [MASK] is better than kobe because le ##bron won the mvp this season ? [SEP]	Lebron	Q36159	better
[CLS] who had the better career : [MASK] or tracy mc ##grad ##y ? [SEP]	Tracy McGrady	Q202295	career
[CLS] why do pp ##l say if [MASK] wins 2 or 3 rings that makes him better than jordan so is kobe already better ? [SEP]	lebron	Q36159	better
[CLS] who do you feel has had the better overall career in the nba steve nash or [MASK] ? [SEP]	Ray Allen	Q208623	career
[CLS] who is the better robin , [MASK] or kobe ? [SEP]	LeBron	Q36159	better
[CLS] who is a better three point shooter , [MASK] or reggie miller ? [SEP]	Ray Allen	Q208623	shooting
[CLS] who is a better player , [MASK] or kobe bryant ? [SEP]	Dwyane Wade	Q31683	better
[CLS] does anyone think that kobe bryant is better than [MASK] in his prime ? [SEP]	Michael Jordan	Q41421	better
[CLS] who do you like better [MASK] or kobe ? [SEP]	lebron	Q36159	better
[CLS] who ##s had a better career ? steve nash or [MASK] [SEP]	Stephon Marbury	Q319336	career
[CLS] what makes kobe better than [MASK] rings only ? [SEP]	LeBron	Q36159	better
[CLS] who will get a ring faster [MASK] or steve nash ? [SEP]	dirk nowitzki	Q44068	other
[CLS] why is kobe bryant at his peak regarded as worse at basketball than [MASK] at his peak ? [SEP]	Michael Jordan	Q41421	other
[CLS] ken ##yon martin or [MASK] who is a better dun ##ker ? ? [SEP]	Jermaine O'neal	Q313499	dunking
[CLS] what makes [MASK] better than kobe ? [SEP]	Jordan	Q41421	better
[CLS] who would like to see [MASK] play 1 - 1 with kobe bryant tomorrow just to see who ##s better ? [SEP]	Michael Jordan	Q41421	better
[CLS] who is better dwight howard or [MASK] [SEP]	andrew bynum	Q314822	better
[CLS] let ' s put the debate to rest . . . in your opinion , who ' s better . . . kobe or [MASK] [SEP]	Lebron	Q36159	better
[CLS] who will have a better career , [MASK] or derrick favors ? [SEP]	Al Farouq Aminu	Q427720	career
[CLS] is kobe playing better than last season , and [MASK] playing a little worse than last season ? [SEP]	Lebron	Q36159	other
[CLS] who ##s a better poster ##izer / dun ##ker ? [MASK] or blake griffin ? [SEP]	amare stoudemire	Q270981	dunking
[CLS] who is stronger mentally , [MASK] or d ##way ##ne wade ? [SEP]	Dwayne Wade	Q31683	strength
[CLS] who will have the better career , [MASK] or jays ##on tatum ? [SEP]	Donovan Mitchell	Q30122104	career
[CLS] who is better bill russell or [MASK] [SEP]	Kareem Abdul Jabbar	Q179051	better
[CLS] who ##s richer le ##bron or [MASK] ? ? [SEP]	kobe	Q25369	money
[CLS] di ##ke ##mbe mu ##tom ##bo or [MASK] . who was the better defender in their prime ? [SEP]	Alonzo Mourning	Q310968	defence
[CLS] what ' s with people that say [MASK] is better than kobe ? [SEP]	L.James	Q36159	better
[CLS] [MASK] or kobe bryant ? who do you like better ? [SEP]	Derrick Rose	Q205326	better
[CLS] [MASK] or carmel ##o anthony who ##s better ? [SEP]	Dwyane Wade	Q31683	better
[CLS] kobe ' s 7 finals appearances and 5 rings . . is that more impressive than jordan ' s 6 and 6 or [MASK] s 9 and 5 ? [SEP]	Magic	Q134183	other
[CLS] who is a better ball player : [MASK] or kobe bryant ? [SEP]	Tracy McGrady	Q202295	better
[CLS] do you guys / girls like [MASK] or kobe better ? [SEP]	Dwayne Wade	Q31683	better
[CLS] would would you say is better : prime kobe bryant or [MASK] [SEP]	Kevin Durant	Q29545	better
[CLS] better perimeter defender : [MASK] or bruce bowen ? [SEP]	Scottie Pippen	Q193637	defence
[CLS] is kevin nash taller than [MASK] [SEP]	the big show	Q44378	height
[CLS] why do lakers fans say kobe is better than [MASK] even though le ##bron is a better player than kobe ? [SEP]	Lebron	Q36159	better
[CLS] if brian scala ##bri ##ne is so bad , why does he have more rings then [MASK] : o ? [SEP]	Lebron James	Q36159	shooting
[CLS] who is better now march 14 , 2012 dwight howard or [MASK] [SEP]	Andrew Bynum	Q314822	better
[CLS] [MASK] or dwight howard ? who ' s better ? [SEP]	Yao Ming	Q58590	better
[CLS] who ' s better all time , sir charles bark ##ley or [MASK] [SEP]	LeBron James	Q36159	better
[CLS] why does [MASK] get paid more than le ##bron ? [SEP]	Shaq	Q169452	money
[CLS] who had a better career [MASK] or kobe ? [SEP]	SHAQ	Q169452	career
[CLS] i think kobe bryant is a better shooter than [MASK] [SEP]	jordan	Q41421	shooting
[CLS] can anyone make a small rap for me about kobe being better than [MASK] [SEP]	Shaq	Q169452	better
[CLS] who is a better player , [MASK] in his prime or kobe bryant in 2004 - 2007 ? [SEP]	Tracy McGrady	Q202295	better
[CLS] who is a better player : kobe or [MASK] [SEP]	Lebron	Q36159	better
[CLS] who is more loved , kobe bryant or [MASK] [SEP]	Paul Pierce	Q121647	other
[CLS] who is better : [MASK] or dwight howard ? [SEP]	Yao Ming	Q58590	better
[CLS] ok , which of the following two stud ##s has more game , paul pierce or [MASK] [SEP]	Dwyane Wade	Q31683	other
[CLS] is [MASK] really a better shooter than reggie miller ? [SEP]	Ray Allen	Q208623	shooting
[CLS] kobe or [MASK] who do you think is better ? [SEP]	Lebron	Q36159	better
[CLS] who is a better 3 ##pt shooter ? mike bi ##bby or [MASK] [SEP]	Mike Bibby	Q311542	shooting
[CLS] whose better dwight howard or [MASK] [SEP]	Joakim Noah	Q311735	better
[CLS] is le ##bron james taller than [MASK] because every ##time they are beside each other le ##bron looks taller ? [SEP]	paul george	Q973121	height
[CLS] who is better : dwight howard or [MASK] [SEP]	Blake Griffin	Q309783	better
[CLS] who ' s more over ##rated , [MASK] or allen iv ##erson ? [SEP]	Shaq	Q169452	popularity
[CLS] who is more athletic [MASK] or dwight howard ? [SEP]	lebron james	Q36159	athletic
[CLS] who ' s more valuable to their team : kobe ( lakers ) or [MASK] heat ) ? [SEP]	LeBron	Q36159	other
[CLS] why do people say [MASK] is king james when most people say kobe bryant is better ? [SEP]	LeBron James	Q36159	better
[CLS] why do people say [MASK] is better then kobe ? [SEP]	L.James	Q36159	better
[CLS] for those of you who think [MASK] is better than kobe . give me one legitimate reason why you think he is ? [SEP]	Jordan	Q41421	better
[CLS] who had the better mvp season [MASK] or kobe bryant ? [SEP]	allen iverson	Q190094	season
[CLS] who is a better point guard [MASK] or peyton si ##va ? [SEP]	Peyton Siva	Q7179634	defence
[CLS] who was a better player , len bias or [MASK] [SEP]	earl manigault	Q1277121	better
[CLS] [MASK] or dr j who is a better player ? [SEP]	Larry bird	Q190152	better
[CLS] how many more titles does kobe bryant have to win to sur ##pass [MASK] [SEP]	Michael Jordan	Q41421	other
[CLS] who is a better tnt analyst ? [MASK] or charles bark ##ley ? [SEP]	Kenny Smith	Q1168929	other
[CLS] who is a better scorer : chris paul or [MASK] [SEP]	Chauncey Billups	Q298531	shooting
[CLS] who is more hated dwight howard or [MASK] [SEP]	Lebron James	Q36159	better
[CLS] poll : who will have a better rookie season , [MASK] or brandon knight ? [SEP]	Kemba Walker	Q166871	season
[CLS] does [MASK] really only need 3 championships and 2 finals mvp to have a better legacy than kobe ? [SEP]	Lebron	Q36159	other
[CLS] why [MASK] deserved the mvp more than kobe bryant this season ? [SEP]	LeBron James	Q36159	other
[CLS] who do you think is a better player : raj ##on ron ##do or [MASK] [SEP]	Mo Williams	Q352118	better
[CLS] do you think [MASK] has higher basketball iq than kobe ? [SEP]	Derek Fisher	Q314621	other
[CLS] if they retire now , who will be a greater player , steve nash or [MASK] [SEP]	Tony Parker	Q193108	other
[CLS] is mug ##gs ##y bog ##ues better than [MASK] [SEP]	Kobe Byrant	Q25369	better
[CLS] who is better rookie kobe rookie dirk or [MASK] [SEP]	Isaiah Thomas	Q336030	better
[CLS] is [MASK] going to be better than kobe bryant in the long run ? [SEP]	Kevin Durant	Q29545	better
[CLS] who is a better shooter , [MASK] or kevin duran ##t ? [SEP]	Stephen Curry	Q352159	shooting
[CLS] who did more to ruin [MASK] s career : m ##j , kobe , or kw ##ame himself ? [SEP]	Kwame Brown	Q317037	other
[CLS] kobe is a better basketball player then [MASK] but athlete , cm ##om ? ? ? [SEP]	LEBRON	Q36159	better
[CLS] who is better driving to the hoop . [MASK] or kobe ? [SEP]	lebron	Q36159	other
[CLS] why does my friend keep saying [MASK] is better than kobe ? [SEP]	Lebron	Q36159	better
[CLS] who has a sex ##ier jump shot ? [MASK] or kobe bryant ? [SEP]	T-Mac	Q202295	other
[CLS] who do you think is better mel ##o or [MASK] [SEP]	lebron	Q36159	better
[CLS] who is more athletic [MASK] or dwight howard ? [SEP]	Blake Griffin	Q309783	athletic
[CLS] who is better [MASK] or paul pierce ? i think kobe is the best but pierce has a cool personality ! ? [SEP]	Paul Pierce	Q121647	better
[CLS] ( not another who is better , kobe or [MASK] but can we compare kobe to jordan ? [SEP]	Kobe	Q25369	other
[CLS] nba : kobe ' s 81 point game or [MASK] s 52 points 11 rebounds 10 assists game . which was more impressive ? [SEP]	LeBron	Q36159	other
[CLS] who is a better shooter [MASK] or kobe bryant ? [SEP]	Steve Nash	Q192955	shooting
[CLS] who i ##z the better point guard [MASK] or jam ##eer nelson ? [SEP]	rajon rondo	Q274469	other
[CLS] who is faster : tony parker or [MASK] [SEP]	Rajon Rondo	Q274469	athletic
[CLS] who accomplished more in their first 11 years , [MASK] or kobe bryant ? [SEP]	MICHAEL JORDAN	Q41421	other
[CLS] can [MASK] be better than dwight howard ? [SEP]	Nikola Vucevic	Q659886	better
[CLS] who ' s the better player ? [MASK] or kobe ? [SEP]	Lebron	Q36159	better
[CLS] best in the nba kobe or [MASK] tell me why you think which one is better ? [SEP]	Lebron	Q36159	better
[CLS] who ' s better , prime andre miller or current [MASK] [SEP]	Ty Lawson	Q520368	better
[CLS] wen kobe and [MASK] retire , who do you think will have the bet ##er career together m ##j , and scott ##ie or kobe and ron ? [SEP]	artest	Q295322	other
[CLS] who ' s the better pg ? jam ##eer nelson or [MASK] [SEP]	Rajon Rondo	Q274469	other
[CLS] who ##s a better shooter [MASK] kobe , dirk ? [SEP]	jordan	Q41421	better
[CLS] do you think kobe will have a better legacy than [MASK] when his career is over ? will kobe be better ? [SEP]	Michael Jordan	Q41421	other
[CLS] [MASK] vs . kobe is more power vs skill ? [SEP]	Lebron	Q36159	other
[CLS] who is a bigger ball - hog , kobe bryant or [MASK] [SEP]	Allen Iverson	Q190094	other
[CLS] who is better , [MASK] or dwight howard ? [SEP]	Blake Griffin	Q309783	better
[CLS] [MASK] vs dwight howard who is more important to magic ? [SEP]	Stan Van Gundy	Q608639	importance
[CLS] did kobe take the number 24 in order to say that he is better than [MASK] [SEP]	Jordan	Q41421	better
[CLS] kobe or [MASK] who led their teams to more losing seasons ? [SEP]	Jordan	Q41421	other
[CLS] so lets finally get this settled , who is better , [MASK] or kobe ? [SEP]	Lebron	Q36159	better
[CLS] who has a better skill set , kobe or [MASK] honest answers ? [SEP]	lebron	Q36159	other
[CLS] does anyone notice that kobe bryant dun ##ks more often ever since the [MASK] trade ? [SEP]	pau gasol	Q193052	other
[CLS] is [MASK] a better nba candidate than kobe bryant ? [SEP]	Lebron James	Q36159	other
[CLS] [MASK] in his prime vs dwight howard , who is better ? [SEP]	Shaq	Q169452	better
[CLS] who is better [MASK] or dwight howard ? [SEP]	Amare Stoudemire	Q270981	better
[CLS] t - mac or [MASK] who had the better nba career ? [SEP]	T-Mac	Q202295	career
[CLS] who ##s better paul pierce or [MASK] [SEP]	Vince Carter	Q241261	better
[CLS] who ##s better ? bill russell or [MASK] [SEP]	Wilt Chamberlain	Q182455	better
[CLS] who is the better overall defender dwight howard or [MASK] [SEP]	Dennis Rodman	Q201608	defence
[CLS] [MASK] vs kobe bryant head to head who won more games kobe or michael ? [SEP]	Michael jordan	Q41421	other
[CLS] is kobe bryant a better basketball player than [MASK] was ? comparing in their prime ##s . . . ? [SEP]	micheal jordan	Q41421	better
[CLS] how is [MASK] not better than dwight howard ? [SEP]	amare stoudemire	Q270981	better
[CLS] to all who think kobe is better than [MASK] ( bt ##w is not true ) ? [SEP]	lebron james	Q36159	better
[CLS] who is a better scorer , ky ##rie irving or [MASK] [SEP]	James Harden	Q136678	shooting
[CLS] [MASK] is already better than dwight howard ? [SEP]	Andrew Bynum	Q314822	better
[CLS] poll : who do you like better kobe bryant or [MASK] [SEP]	MICHEAL JORDAN	Q41421	better
[CLS] did you know last year [MASK] had a better 3 ##p % better than kobe bryant ? [SEP]	Lebron James	Q36159	other
[CLS] honestly who do you think will be better kobe or [MASK] when its all said and done ? [SEP]	JORDAN	Q41421	better
[CLS] who ##s the better player : [MASK] or kobe bryant ? [SEP]	dwayne wade	Q31683	better
[CLS] is it fair to say the year kobe won mvp , [MASK] deserved it more ? [SEP]	Chris Paul	Q46040	other
[CLS] who is a better free throw shooter ? [MASK] or kobe ? [SEP]	LeBron	Q36159	shooting
[CLS] why the hell do people say [MASK] is a better shooter than steve nash ? [SEP]	Ray Allen	Q208623	shooting
[CLS] who is a better fit for the lakers - ron arte ##st or [MASK] [SEP]	Trevor Ariza	Q358108	athletic
[CLS] raja ##n ron ##do or [MASK] who do you think is better ? [SEP]	derrick rose	Q205326	better
[CLS] who ' s better paul pierce or [MASK] [SEP]	carmelo anthony	Q129041	better
[CLS] who is a better better basketball player , [MASK] or kobe bryant ? [SEP]	Lebron James	Q36159	better
[CLS] who is more over ##rated james worthy or [MASK] [SEP]	Elgin Baylor	Q357458	popularity
[CLS] why [MASK] is better than tyre ##ke evans ? agree ? [SEP]	Stephen Curry	Q352159	better
[CLS] more over ##rated as a defender bruce bowen or [MASK] [SEP]	Ron Artest	Q295322	popularity
[CLS] who is a better closer . . . kobe bryant , or [MASK] [SEP]	Micheal Jordan	Q41421	other
[CLS] who is better ; paul pierce or [MASK] [SEP]	rudy gay	Q370275	better
[CLS] how come people keep saying that kobe bryant is better than [MASK] [SEP]	Lebron james	Q36159	better
[CLS] who ' s a better shooter damian lil ##lard or [MASK] [SEP]	Damian Lillard	Q622308	shooting
[CLS] who ' s a better sg ; [MASK] or kobe bryant ? [SEP]	Klay Thompson	Q29342	shooting
[CLS] i admit it . . os ##iri ##s . [MASK] is a way better player than rudy gay . ? [SEP]	Carmelo Anthony	Q129041	better
[CLS] why is it so important for people to want [MASK] to be better than kobe ? [SEP]	Lebron	Q36159	better
[CLS] is [MASK] going to be better than kobe in the future ? [SEP]	Lebron	Q36159	better
[CLS] who was more dominant at their respective positions , [MASK] or wil ##t chamberlain ? [SEP]	Michael Jordan	Q41421	importance
[CLS] who ' s more under ##rated : [MASK] or dr ##ay ##mond green ? [SEP]	Draymond Green	Q2614593	popularity
[CLS] who is better [MASK] or dwight howard . ? [SEP]	Pau Gasol	Q193052	better
[CLS] why is [MASK] so much better then paul pierce ? [SEP]	Kobe Bryant	Q25369	better
[CLS] why do people say [MASK] cheat when kobe cheat 100 ##x more ? [SEP]	Lebron	Q36159	other
[CLS] who had the better career : vince carter or [MASK] [SEP]	Tracy McGrady	Q202295	career
[CLS] would you say carmel ##o anthony is a top 5 player ? i think curry , k ##d , lb ##j and [MASK] are better than him but that is . ? [SEP]	cp3	Q46040	better
[CLS] who has more fans kobe or [MASK] [SEP]	lebron	Q36159	other
[CLS] buy or sell : charles bark ##ley was a better overall p ##f than [MASK] [SEP]	Karl Malone	Q199896	forward
[CLS] how does kobe having 3 rings have anything to with him being better than [MASK] now ? [SEP]	LeBron	Q36159	other
[CLS] who ##s more clutch kobe or [MASK] [SEP]	melo	Q129041	clutch
[CLS] who is better [MASK] or dwight howard ? [SEP]	Andrew bynum	Q314822	better
[CLS] [MASK] vs kevin duran ##t who ' s the better scorer ? [SEP]	Carmelo Anthony	Q129041	shooting
[CLS] is [MASK] taller than the big show ? [SEP]	Kevin Nash	Q280793	height
[CLS] is [MASK] worth more money than kobe bryant ? [SEP]	Lebron James	Q36159	other
[CLS] does anyone still think [MASK] is greater than jordan / kobe ? [SEP]	LeBron	Q36159	other
[CLS] is it just me or does kobe actually get compared to m ##j more than [MASK] [SEP]	LeBron	Q36159	other
[CLS] do you really think kobe is any more loyal than [MASK] [SEP]	LeBron	Q36159	other
[CLS] who is taller yao ming or [MASK] [SEP]	Shawn Bradley	Q57596	height
[CLS] who ' s a better dun ##ker : zach la ##vine or [MASK] [SEP]	Michael Jordan	Q41421	dunking
[CLS] who will have more rings kevin duran ##t or [MASK] [SEP]	Lebron	Q36159	shooting
[CLS] who will have the better career ? [MASK] or le ##bron james ? [SEP]	kevin durant	Q29545	career
[CLS] kobe or [MASK] better career ? [SEP]	Shaq	Q169452	career
[CLS] who drives in better to the basket , kobe or [MASK] [SEP]	LEBRON	Q36159	other
[CLS] stan van gun ##dy vs [MASK] who is more important to magic ? [SEP]	Dwight Howard	Q25278	importance
[CLS] who will be a better player this year : [MASK] or rudy gay ? [SEP]	lamarcus aldridge	Q316243	better
[CLS] who is much better player in nba , [MASK] or carmel ##o anthony ? [SEP]	Lebron James	Q36159	better
[CLS] do you think [MASK] will have a better career than nick van ex ##el ? [SEP]	Brandon Jennings	Q314409	career
[CLS] who ' s more over ##rated [MASK] or chris webber ? [SEP]	Alonzo Mourning	Q310968	popularity
[CLS] if you think kobe is better than [MASK] watch this game . what do you think ? [SEP]	Jordan	Q41421	better
[CLS] [MASK] kobe bryant , who is the better basketball player ? [SEP]	Allen Iverson	Q190094	better
[CLS] who ' s a bigger flop : [MASK] or kobe bryant ? [SEP]	Kwame Brown	Q317037	other
[CLS] do you think [MASK] and josh child ##ress will be better nba players if they come back to the nba ? [SEP]	gerald green	Q722629	other
[CLS] who is more clutch ? [MASK] or kobe ? [SEP]	LBJ	Q36159	clutch
[CLS] when both their careers are finished who will be considered better : [MASK] vs kobe bryant ? [SEP]	Lebron James	Q36159	career
[CLS] who is better dun ##ker , le ##bron or [MASK] ? [SEP]	Dwight Howard	Q25278	dunking
[CLS] why does everybody think [MASK] is better than kobe ? [SEP]	Lebron	Q36159	better
[CLS] who ##s more athletic [MASK] or dwight howard ? [SEP]	deandre jordan	Q60478	athletic
[CLS] who is a better point guard trey burke or [MASK] [SEP]	Peyton Siva	Q7179634	defence
[CLS] why do so many people think steve nash is better than [MASK] [SEP]	John Stockton	Q213346	better
[CLS] would you say right now [MASK] had a better career then kobe bryant so far ? [SEP]	lebron james	Q36159	career
[CLS] who ' s won more titles - [MASK] or steve nash ? [SEP]	Robert Horry	Q364394	other
[CLS] is kobe bryant a better basketball player that [MASK] [SEP]	lebron james	Q36159	better
[CLS] is kobe bryant bigger playoff choke ##r than [MASK] [SEP]	Dirk Nowitzki	Q44068	other
[CLS] who has a better career 3 point shooting percentage , [MASK] or steve nash ? [SEP]	Ray Allen	Q208623	career
[CLS] who ' s more over ##rated [MASK] or steve nash ? [SEP]	Yao Ming	Q58590	popularity
[CLS] magic , bird , duncan , kobe , m ##j , russell , wil ##t . guess what [MASK] you will never be better than them ? [SEP]	Lebron	Q36159	better
[CLS] d rose is av ##re ##ging more blocks per game than griffin [MASK] and kobe ? [SEP]	lebron	Q36159	other
[CLS] who ' s more under ##rated ? josh smith or [MASK] [SEP]	Tayshaun Prince	Q295521	popularity
[CLS] who ##s faster john wall or [MASK] [SEP]	derrick rose	Q205326	athletic
[CLS] who is better duo ? [MASK] & kobe or sha ##q & by ##num ? [SEP]	Shaq	Q169452	other
[CLS] ok last question for me : better career [MASK] or steve nash ? [SEP]	Ray Allen	Q208623	career
[CLS] who is better for the lakers ? [MASK] or jo ##die meek ##s ? [SEP]	cj miles	Q1022508	better
[CLS] after last night , you want to tell me [MASK] is better than kobe ? [SEP]	LeBron	Q36159	better
[CLS] who is the better player , kobe bryant or [MASK] [SEP]	Micheal Jordan	Q41421	better
[CLS] how can you possibly think kobe is better than [MASK] ! ? [SEP]	Lebron	Q36159	better
[CLS] who was a better basketball player overall : [MASK] or dominique wilkins ? [SEP]	Clyde Drexler	Q295340	better
[CLS] who do you think would be better at coaching : steve nash or [MASK] ? [SEP]	john stockton	Q213346	better
[CLS] who ' s a better overall player ? [MASK] or k bryant ? [SEP]	D Rose	Q205326	better
[CLS] do you guys how say [MASK] is better than kobe actually ? [SEP]	Lebron	Q36159	better
[CLS] who is a better scorer between chris paul & [MASK] [SEP]	Chauncey Billups	Q298531	shooting
[CLS] if kobe is better than [MASK] does that mean jordan is really bad ? [SEP]	Kobe	Q25369	better
[CLS] who ##s more clutch [MASK] or michael jordan ? [SEP]	Lebron	Q36159	clutch
[CLS] poll : who will have a better rookie season , ke ##mba walker or [MASK] [SEP]	Brandon Knight	Q935879	season
[CLS] who accomplished more in there first 12 seasons , [MASK] or kobe bryant ? [SEP]	Michael Jordan	Q41421	other
[CLS] basketball : who has a better chance to break the all - time scoring record , [MASK] or kobe ? [SEP]	Lebron	Q36159	other
[CLS] why do people believe kobe is better then [MASK] [SEP]	lebron	Q36159	better
[CLS] who will have more points tonight , kobe or [MASK] [SEP]	Melo	Q129041	other
[CLS] buy or sell ? [MASK] is a better player than kobe ? [SEP]	Pippen	Q193637	better
[CLS] people always say [MASK] had the worst team over kobe tell me who had the better team ? [SEP]	Lebron	Q36159	other
[CLS] who will finish their career with more mvp awards , [MASK] or kobe ? [SEP]	Lebron	Q36159	other
[CLS] why do kobe fans say that kobe is better than [MASK] because of rings ? [SEP]	lebron	Q36159	better
[CLS] how is kobe more clutch than [MASK] [SEP]	LeBron	Q36159	clutch
[CLS] who is a better basketball player steve nash or [MASK] [SEP]	tony parker	Q193108	better
[CLS] who is a better player ? [MASK] or , z ##yd ##runa ##s il ##gau ##ska ##s ? ? asa ##p ! ? [SEP]	PAU GASOL	Q193052	better
[CLS] why is the media so hell bent on insulting michael jordan ? [MASK] is more athletic ? ? [SEP]	LeBron	Q36159	athletic
[CLS] kobe has 4 rings , 2 more and he ' ll match [MASK] how will he be viewed then ? [SEP]	Jordan	Q41421	other
[CLS] who is faster [MASK] or raj ##on ron ##do ? [SEP]	Sebastian Telfair	Q547217	athletic
[CLS] [MASK] or kobe who is a better team leader ? ? ? ? ? ? ? ? ? [SEP]	Lebron	Q36159	other
[CLS] basketball : more athletic : wil ##t or [MASK] [SEP]	LeBron	Q36159	athletic
[CLS] true or false : raj ##on ron ##do is a better player than [MASK] [SEP]	Russell Westbrook	Q196185	better
[CLS] who is a much better point ##guard ? ? ? ? [MASK] or steve nash ? ? ? why ? ? ? [SEP]	jason kidd	Q221341	other
[CLS] wow are you people really that stupid saying kobe is better than [MASK] [SEP]	Jordan	Q41421	better
[CLS] thoughts on [MASK] saying steve nash may be a better all around player than jordan ? [SEP]	Scottie Pippen	Q193637	other
[CLS] agree or disagree : kobe winning 5th ring doesn ' t prove he ' s better than [MASK] [SEP]	Lebron	Q36159	better
[CLS] bigger ball ##hog : kobe or [MASK] [SEP]	Jordan	Q41421	other
[CLS] let ' s put this into perspective . people say [MASK] is better than kobe ? lets analyze shall we ? [SEP]	Lebron	Q36159	better
[CLS] who had a better individual performance vs the magic , [MASK] or kobe bryant ? [SEP]	Lebron James	Q36159	other
[CLS] what ' s better , [MASK] s come back win in game 3 in the nba finals ( 6 min left 13 point deficit ) or kobe ' s 81 [SEP]	D-Wade	Q31683	other
[CLS] agree or disagree ? [MASK] would make the lakers a better team than kobe bryant does ? [SEP]	LeBron James	Q36159	other
[CLS] who was a better shot creator , kobe bryant or [MASK] [SEP]	Michael Jordan	Q41421	shooting
[CLS] who ' s the better shooter , [MASK] or dr ##ose ? [SEP]	Lebron	Q36159	shooting
[CLS] who has more finals mvp ' s , kobe bryant or [MASK] [SEP]	LeBron James	Q36159	other
[CLS] who is better : tyre ##ke evans or [MASK] [SEP]	Brandon Jennings	Q314409	better
[CLS] who ' s more under ##rated ? michael red ##d or [MASK] [SEP]	Tayshaun Prince	Q295521	popularity
[CLS] [MASK] at 25 or kobe at 28 , who done more ? [SEP]	Dwyane Wade	Q31683	other
[CLS] why do you clown ##s think kobe is better than [MASK] [SEP]	Lebron	Q36159	better
[CLS] [MASK] or vince carter who had the better nba career ? [SEP]	T-Mac	Q202295	career
[CLS] who is more humble [MASK] or kobe ? [SEP]	Lebron	Q36159	other
[CLS] did you know that [MASK] was better than kobe bryant ? [SEP]	Michael Jordan	Q41421	better
[CLS] who ' s the better player ? [MASK] or raj ##on ron ##do ? [SEP]	Kyle Lowry	Q974603	better
[CLS] nba : who had more points tonight ? [MASK] or kobe bryant ? how much each did they have ? [SEP]	Amare Stoudemire	Q270981	other
[CLS] why do [MASK] fans say le ##bron is better then kobe today , when before kobe spain ##ed his finger he was the mvp ? [SEP]	Lebron	Q36159	better
[CLS] will hash ##eem tha ##bee ##t end up being a bigger bust than [MASK] [SEP]	Darko Milicic	Q316256	other
[CLS] isn ' t paul pierce a much better leader than [MASK] [SEP]	lebron	Q36159	other
[CLS] who is more clutch ? [MASK] or kobe ? [SEP]	Robert Horry	Q364394	clutch
[CLS] who is faster between [MASK] and raj ##on ron ##do ? [SEP]	Derrick Rose	Q205326	athletic
[CLS] does devin harris look taller than [MASK] to you ? [SEP]	Steve Nash	Q192955	height
[CLS] who ' s better , [MASK] or paul pierce ? [SEP]	Ron Artest	Q295322	better
[CLS] i think [MASK] is much better player than kobe after watching olympics . ? [SEP]	Lebron	Q36159	better
[CLS] nba how can [MASK] get mvp when he ##s nearly not better than stockton , jerry west , or baylor ? [SEP]	steve nash	Q192955	better
[CLS] is it more important for cavalier band ##wa ##gon to prove [MASK] is better than kobe . . . . . ? [SEP]	Lebron	Q36159	importance
[CLS] kobe or [MASK] - who is more clutch ? [SEP]	LeBron James	Q36159	clutch
[CLS] who is richer ? michael jordan or [MASK] explain it . ? [SEP]	Shaquille O'neal	Q169452	money
[CLS] who ' s quicker : [MASK] or prime allen iv ##erson ? [SEP]	Derrick Rose	Q205326	athletic
[CLS] who is a better lake ##r kobe bryant or [MASK] and why ? [SEP]	magic johnson	Q134183	other
[CLS] who is the better dun ##ker [MASK] or josh smith ? [SEP]	Vince Carter	Q241261	dunking
[CLS] who will have a better career by estimation ? [MASK] or chris paul ? [SEP]	Brandon Roy	Q313485	career
[CLS] why do people say [MASK] is better than kobe ? [SEP]	Lebron	Q36159	better
[CLS] how is kobe a better leader and player than [MASK] [SEP]	Lebron	Q36159	other
[CLS] who is quicker , [MASK] or devin harris ? [SEP]	Rajon Rondo	Q274469	athletic
[CLS] why has [MASK] lost more nba finals games than steve nash ? [SEP]	kobe	Q25369	other
[CLS] which feat is more impressive : kobe ' s 3 - peat or [MASK] making it to the finals 5 years in a row ? [SEP]	Lebron	Q36159	other
[CLS] who has a more mania ##cal work et ##hic , kobe bryant or [MASK] [SEP]	Michael Jordan	Q41421	other
[CLS] who is more dominant in the post , prime [MASK] or ham ##ed had ##dad ##i ? [SEP]	Shaq	Q169452	importance
[CLS] dwight howard or [MASK] . . . who is better ? [SEP]	ANDREW Bynum	Q314822	better
[CLS] who had a better regular season [MASK] or d wade ? [SEP]	Kobe	Q25369	season
[CLS] who is more over ##rated ? [MASK] or kobe bryant ? [SEP]	Phil Jackson	Q316246	popularity
[CLS] who was a better six ##er & had a better career , charles bark ##ley or [MASK] [SEP]	Allen Iverson	Q190094	other
[CLS] who had the better mvp season allen iv ##erson or [MASK] [SEP]	allen iverson	Q190094	season
[CLS] why [MASK] was a better scorer than kobe bryant ? [SEP]	Michael Jordan	Q41421	shooting
[CLS] did [MASK] penetrate the rim more then kobe bryant ? [SEP]	Michael Jordan	Q41421	other
[CLS] franchise players ( bryant , [MASK] etc . ) vs . compliment ##ary players , who ' s got better chance of winning a ring ? [SEP]	mcgrady	Q202295	other
[CLS] why is kobe hated for doing what [MASK] did better than jordan did it ? [SEP]	Kobe	Q25369	other
[CLS] who ##s a better mvp candidate - kobe bryant or [MASK] [SEP]	lebron james	Q36159	better
[CLS] why do people think [MASK] is better than kobe ? [SEP]	LeBron	Q36159	better
[CLS] do you think that [MASK] is better than kobe bryant ? [SEP]	Lebron James	Q36159	better
[CLS] who is better ? prime paul pierce or [MASK] [SEP]	Melo	Q129041	better
[CLS] if kobe wins more titles than [MASK] by the end of his career who is the better player ? [SEP]	Michael Jordan	Q41421	better
[CLS] fantasy basketball question : why do people think raj ##on ron ##do is better than [MASK] in fantasy basketball ? [SEP]	Chris Paul	Q46040	better
[CLS] who ' s more clutch gary neal or [MASK] [SEP]	LeBron	Q36159	clutch
[CLS] why do so many people believe that kobe is better than [MASK] [SEP]	jordan	Q41421	better
[CLS] can we all agree [MASK] is made the lakers better than trevor ari ##za ? [SEP]	Ron Artest	Q295322	other
[CLS] why is paul pierce better then [MASK] oh , that ' s right because kobe sucks , and pierce is the best ! ? [SEP]	Kobe Bryant	Q25369	better
[CLS] nba how can steve nash get mvp when he ##s nearly not better than stockton , [MASK] or baylor ? [SEP]	jerry west	Q311195	better
[CLS] zach randolph claims he is better than [MASK] . any opinions ? [SEP]	CHRIS BOSH	Q201386	better
[CLS] who is more clutch [MASK] or kobe ? [SEP]	Carmelo	Q129041	clutch
[CLS] how can people think [MASK] is better then kobe ? [SEP]	LeBron	Q36159	better
[CLS] what is more impressive , kobe bryant ' s 81 points or [MASK] s 100 points ? [SEP]	Wilt Chamberlain	Q182455	other
[CLS] lake ##r fans , why do you think kobe bryant was able to have a longer and more prolific career than [MASK] [SEP]	Shaq	Q169452	other
[CLS] duran ##t vs [MASK] who ##s the better scorer ? [SEP]	Lebron	Q36159	shooting
[CLS] will [MASK] score more points than kobe bryant when both of their careers are over ? [SEP]	lebron james	Q36159	other
[CLS] buy or sell [MASK] will have a better career than kobe ? [SEP]	lebron	Q36159	career
[CLS] who is a better sg : kobe bryant or [MASK] [SEP]	Jerry West	Q311195	shooting
[CLS] who is a better athlete . [MASK] or michael jordan ? [SEP]	Jim Thorpe	Q221482	athletic
[CLS] who is a better pg : [MASK] or steve nash ? [SEP]	Jeremy Lin	Q309590	other
[CLS] do you find it funny that kobe fans fail to admit [MASK] is better ? [SEP]	Lebron	Q36159	better
[CLS] answer this [MASK] fans : how is le ##bron better than kobe ? [SEP]	LeBron	Q36159	better
[CLS] so now that you saw what pierce can do . who ##s really better [MASK] or paul pierce ? [SEP]	kobe bryant	Q25369	better
[CLS] how is kobe a better scorer than [MASK] [SEP]	Lebron	Q36159	shooting
[CLS] has [MASK] really ever been a better basketball player than kobe bryant ? [SEP]	Shaquille	Q169452	better
[CLS] who is a better team player kobe or [MASK] [SEP]	LeBron	Q36159	better
[CLS] buy or sell : this photo is the reason why [MASK] is better than kobe bryant ? [SEP]	Lebron James	Q36159	better
[CLS] did you know that [MASK] has missed the playoffs more times than kobe bryant ? [SEP]	LeBron James	Q36159	other
[CLS] who is a better player overall kobe or [MASK] [SEP]	Lebron	Q36159	better
[CLS] is dem ##ar der ##oza ##n the greatest of all time ? even better than [MASK] [SEP]	Jordan	Q41421	better
[CLS] was [MASK] a bigger prep star than kobe bryant ? [SEP]	James Worthy	Q362872	other
[CLS] who do you guys think is better [MASK] or rudy gay ? [SEP]	Andre Iguodala	Q136816	better
[CLS] who jumps higher kobe bryant or [MASK] [SEP]	Lebron James	Q36159	other
[CLS] is [MASK] better than paul pierce ? [SEP]	Brandon Roy	Q313485	better
[CLS] which player is more likely to acc ##omp ##lls ##h a quad ##rip ##le double in his nba career , kobe bryant or [MASK] [SEP]	Lebron James	Q36159	other
[CLS] who is more important to the san antonio spurs ? [MASK] or tony parker ? [SEP]	Ginobili	Q213132	importance
[CLS] who ##s faster [MASK] or shannon brown ? [SEP]	jordan farmar	Q313045	athletic
[CLS] how come people think [MASK] is more hall of fame worthy than paul pierce ? [SEP]	Ray Allen	Q208623	other
[CLS] is lakers fans saying kobe ( in his prime ) is better than [MASK] in prime an example of how del ##usion ##al they are ? [SEP]	Shaq	Q169452	better
[CLS] dwight howard , [MASK] who ' s better ? [SEP]	Shaquille O'neal	Q169452	better
[CLS] kobe or [MASK] who has more fans ? [SEP]	Lebron	Q36159	other
[CLS] [MASK] or john wall ; who is faster ? [SEP]	Derrick Rose	Q205326	athletic
[CLS] who is stronger kobe or [MASK] [SEP]	tracy mcgrady	Q202295	strength
[CLS] who ' s a better shooter in your opinion : [MASK] or kobe bryant ? [SEP]	Ray Allen	Q208623	shooting
[CLS] who is better now , [MASK] or dwight howard ? [SEP]	Andrew Bynum	Q314822	better
[CLS] here is an opinion base answer why [MASK] is better than kobe ? [SEP]	Lebron	Q36159	better
[CLS] who is a better scorer : [MASK] or kevin duran ##t ? [SEP]	Carmelo	Q129041	shooting
[CLS] who was a better player ? dominique wilkins or [MASK] [SEP]	clyde drexler	Q295340	better
[CLS] whose more under ##rated : [MASK] or rudy gay ? [SEP]	Luol Deng	Q275183	popularity
[CLS] do you think [MASK] gets more attention then kobe ? ? ? [SEP]	Lebron	Q36159	other
[CLS] who is taller , [MASK] jordan or bird ? [SEP]	Magic	Q134183	height
[CLS] who will have the better career , donovan mitchell or [MASK] [SEP]	Jayson Tatum	Q21623063	career
[CLS] who is richer michael jordan or [MASK] [SEP]	magic Johnson	Q134183	money
[CLS] who is a better nba player carmel ##o anthony or [MASK] [SEP]	Kevin Durant	Q29545	better
[CLS] who will score more points ? kobe or [MASK] ? [SEP]	Lebron	Q36159	other
[CLS] who is better dem ##ar der ##oza ##n or [MASK] [SEP]	Kyle Lowry	Q974603	better
[CLS] who is better ? [MASK] vs . paul pierce ? [SEP]	Tracy Mcgrady	Q202295	better
[CLS] [MASK] or al ##onzo mourning . . who was the better defender in their prime ? [SEP]	Alonzo Mourning	Q310968	defence
[CLS] who is the better basketball player ? kobe or [MASK] [SEP]	iverson	Q190094	better
[CLS] how stupid am i for saying [MASK] is better than kobe bryant ? [SEP]	jerry west	Q311195	better
[CLS] who will have a better career [MASK] or le ##bron ? [SEP]	kobe	Q25369	career
[CLS] who ' s better kobe bryant or [MASK] just want to hear you opinion ? [SEP]	lebron James	Q36159	better
[CLS] who was more vital to their teams success : james pose ##y for the 08 celtics or [MASK] for the 09 lakers ? [SEP]	Trevor Ariza	Q358108	importance
[CLS] how in the hell is [MASK] a better overall player than kobe ? ? ? ? ? ? [SEP]	Lebron	Q36159	better
[CLS] how many inches taller than michael jordan is [MASK] [SEP]	Wilt Chamberlain	Q182455	height
[CLS] some people say that kobe is better than [MASK] michael jordan . . so who do you think is better ? [SEP]	MJ	Q41421	better
[CLS] who is more clutch , [MASK] vs derrick rose ? [SEP]	Kyrie Irving	Q348618	clutch
[CLS] who is a better player at this point in their careers , [MASK] or kobe bryant ? [SEP]	Dwyane Wade	Q31683	better
[CLS] did you guys know [MASK] is more important to the lakers than kobe ? [SEP]	pau gasol	Q193052	other
[CLS] kobe bryant better player than [MASK] but jordan ##s the best ? [SEP]	Kobe Bryant	Q25369	better
[CLS] which player is better [MASK] or dwight howard ? [SEP]	Chris Paul	Q46040	better
[CLS] who has more mvp ##s kobe bryant or [MASK] [SEP]	steve nash	Q192955	other
[CLS] who do you guys think is better [MASK] or z ##yd ##runa ##s il ##gau ##ska ##s ? reasons ? [SEP]	Pau Gasol	Q193052	better
[CLS] who will have a better career , al far ##ou ##q amin ##u or [MASK] [SEP]	Al Farouq Aminu	Q427720	career
[CLS] who a better scorer [MASK] or kevin duran ##t ? [SEP]	Carmelo Anthony	Q129041	shooting
[CLS] who ##s the better nba player kobe or [MASK] [SEP]	T-Mac	Q202295	better
[CLS] who is more clutch , [MASK] or steve nash ? ( nba clutch tournament round # 1 ) ? [SEP]	LeBron James	Q36159	clutch
[CLS] who ' s the better player , [MASK] or steve nash ? [SEP]	Dwayne Wade	Q31683	better
[CLS] did steve nash make [MASK] better ? [SEP]	Stromile Swift	Q716062	other
[CLS] okay . . . so who is better , paul pierce or [MASK] [SEP]	LeBron James	Q36159	better
[CLS] who had a better supporting cast this past season , [MASK] or kobe bryant ? [SEP]	Steve Nash	Q192955	other
[CLS] who will have more 4 point plays in their career ? kobe bryant ( kb ##24 ) or [MASK] the king ) ? [SEP]	LeBron James	Q36159	other
[CLS] do u think [MASK] will ever score more the kobe did when he scored 81 + b ##q ? [SEP]	lebron	Q36159	other
[CLS] who ##s a better dun ##ker , gerald green of [MASK] [SEP]	Lebron	Q36159	dunking
[CLS] why does ant ##aw ##n jam ##ison get paid more than [MASK] [SEP]	gilbert arenas	Q310108	money
[CLS] agree or disagree : [MASK] is better than kobe ? [SEP]	Lebron	Q36159	better
[CLS] who is a better sg : [MASK] or jerry west ? [SEP]	Kobe Bryant	Q25369	shooting
[CLS] if [MASK] wins 5 mvp ' s & 1 ring and kobe finishes with 1 mvp and 5 rings , who ' s better all time ? [SEP]	Lebron	Q36159	better
[CLS] who do you like better [MASK] or kobe bryant ? [SEP]	LeBron James	Q36159	better
[CLS] who is more athletic [MASK] or russell west ##brook ? [SEP]	Derrick Rose	Q205326	athletic
[CLS] who is stronger : [MASK] or brian scala ##bri ##ne ? [SEP]	Earl Boykins	Q313473	strength
[CLS] realistic ##ally , who is the better player and worth more to his team , kobe or [MASK] [SEP]	Lebron	Q36159	better
[CLS] who was better player till the age of 30 , [MASK] or kobe bryant ? [SEP]	Michael Jordan	Q41421	better
[CLS] who is more clutch kobe bryant or [MASK] [SEP]	Lebron James	Q36159	clutch
[CLS] why do people think that kobe is better than [MASK] when le ##bron won the mvp ? [SEP]	Lebron	Q36159	better
[CLS] what was more dumb : charles bark ##ley spitting at a girl or [MASK] fighting a fan ? [SEP]	Ron Artest	Q295322	other
[CLS] who ##s better [MASK] or kobe ? [SEP]	MJ	Q41421	better
[CLS] [MASK] a bigger chuck ##er than kobe in the mid 2000s ? [SEP]	Westbrook	Q196185	other
[CLS] who has more rings ? brian scala ##bri ##ne or [MASK] [SEP]	LeBron James	Q36159	shooting
[CLS] who has a better resume , [MASK] or kobe bryant ? [SEP]	Hakeem Olajuwon	Q273256	career
[CLS] will le ##bron james have a better career individually than [MASK] when its said and done ? [SEP]	Kobe	Q25369	career
[CLS] who do you guys think is better [MASK] or rudy gay ? that ' s about the hardest question to answer . ? [SEP]	Andre Iguodala	Q136816	better
[CLS] who is a better scorer [MASK] or kevin duran ##t ? [SEP]	carmelo anthony	Q129041	shooting
[CLS] who is a better player currently , [MASK] or kobe bryant ? why ? [SEP]	Dwyane Wade	Q31683	better
[CLS] could anyone prove who ' s better between [MASK] or kobe bryant ? [SEP]	Michael Jordan	Q41421	better
[CLS] who is better b - ball player ? ? ? kobe bryant or [MASK] [SEP]	Lebron James	Q36159	better
[CLS] do you agree with me : tom brady is better than peyton manning and kobe bryant is better than [MASK] [SEP]	LeBron James	Q36159	better
[CLS] who was more dominant : [MASK] or wil ##t chamberlain ? [SEP]	Rafer Alston	Q918855	importance
[CLS] agree or disagree : [MASK] is a better defender than kobe bryant ? [SEP]	Gary Payton	Q309872	defence
[CLS] who ##s more clutch [MASK] or kobe ? [SEP]	MELO	Q129041	other
[CLS] my friend just told me kobe is better than [MASK] [SEP]	Larry Bird	Q190152	better
[CLS] who ' s loved more in new york . . . [MASK] kobe or wade ? [SEP]	Lebron	Q36159	other
[CLS] who is stronger le ##bron james or [MASK] [SEP]	dwight howard	Q25278	strength
[CLS] who is better , [MASK] or dwight howard ? [SEP]	David Robinson	Q211876	better
[CLS] who do you think is better kobe bryant or [MASK] overall as a shooting guard ? [SEP]	Michael jordan	Q41421	better
[CLS] say it with me [MASK] fans , luke walton has more rings than le ##bron ? [SEP]	LeBron	Q36159	shooting
[CLS] why do people say that [MASK] cannot be greater than kobe or magic even if he wins 4 - 5 rings in miami ? [SEP]	Lebron	Q36159	other
[CLS] who is stronger : le ##bron or [MASK] [SEP]	Andre Iguodala	Q136816	strength
[CLS] is [MASK] closer to ec ##lip ##sing kobe than kobe is to ec ##lip ##sing jordan ? [SEP]	Lebron	Q36159	other
[CLS] [MASK] vs kobe bryant , le ##bron is better overall ? [SEP]	Lebron James	Q36159	better
[CLS] who do you think was more valuable to the ma ##vs ? steve nash or [MASK] [SEP]	Dirk Nowitzki	Q44068	other
[CLS] will kobe ever be a better player than [MASK] [SEP]	Jordan	Q41421	better
[CLS] what makes kobe bryant better than [MASK] [SEP]	Ray Allen	Q208623	better
[CLS] how did [MASK] get his ring quicker than kobe bryant if kobe bryant is better than d ##way ##ne wade ? [SEP]	Dwayne Wade	Q31683	better
[CLS] who is better ? [MASK] or bill russell ? [SEP]	Wilt Chamberlain	Q182455	better
[CLS] was [MASK] more important to the bulls then what steve nash is for the suns ? [SEP]	Michael Jordan	Q41421	importance
[CLS] who is better [MASK] or z ##yd ##runa ##s il ##gau ##ska ##s ? [SEP]	Hedo Turkoglu	Q298981	better
[CLS] who was a better player , [MASK] or dominique wilkins ? [SEP]	James Worthy	Q362872	better
[CLS] was [MASK] ( in his prime ) a better player than kobe ? [SEP]	Penny Hardaway	Q317209	better
[CLS] who is still saying that [MASK] is better than kobe after kobe ' s 61 point record performance ? [SEP]	lebron james	Q36159	better
[CLS] who has had a better nba career : steve nash or [MASK] [SEP]	Allen iverson	Q190094	career
[CLS] why do [MASK] fan ##atics get upset over the fact that kobe is better ? [SEP]	Michael Jordan	Q41421	better
[CLS] which nba player is better ? jamal crawford or [MASK] [SEP]	Larry Hughes	Q725890	better
[CLS] why should [MASK] get mvp . . . . when kobe bryant deserves it way more ? [SEP]	Chris Paul	Q46040	other
[CLS] who is easier to dun ##k on ? [MASK] or kobe ? [SEP]	LeBron	Q36159	other
[CLS] why nike is too focus on making le ##bron shoes better design then kobe & [MASK] [SEP]	Durant	Q29545	other
[CLS] who has more speed [MASK] or kobe ? [SEP]	Lebron	Q36159	other
[CLS] what would make a better nba player jordan combined with magic or kobe combined with [MASK] + b ##q ? [SEP]	lebron	Q36159	other
[CLS] is it official that [MASK] is better than dwight howard ? [SEP]	Pau Gasol	Q193052	better
[CLS] who has been more clutch in his career , [MASK] or kobe bryant ? [SEP]	LeBron James	Q36159	clutch
[CLS] is paul pierce better than [MASK] [SEP]	kobe	Q25369	better
[CLS] who is a better shooter , kobe bryant or [MASK] + b ##q ? [SEP]	Steve Nash	Q192955	shooting
[CLS] who ' s better ? bill russell or [MASK] [SEP]	Michael Jordan	Q41421	better
[CLS] who is more over ##rated ? [MASK] or kobe bryant ? [SEP]	Bill Russell	Q242185	popularity
[CLS] who has a better supporting cast , [MASK] or kobe ? [SEP]	lebron	Q36159	other
[CLS] who thinks [MASK] is better than steve nash ? [SEP]	Jason Kidd	Q221341	better
[CLS] who do you think is a better player kobe or [MASK] [SEP]	lebron	Q36159	better
[CLS] who ##s better . [MASK] or paul pierce ? [SEP]	Luol deng	Q275183	better
[CLS] if kobe and [MASK] switched teams who ' s team would be better ? [SEP]	Lebron	Q36159	better
[CLS] how come [MASK] has to do a lot more for the ca ##vs to win than kobe has to do for la ? [SEP]	lebron james	Q36159	other
[CLS] who do you think has a better career [MASK] or tracy mc ##grad ##y ? [SEP]	Tracy McGrady	Q202295	career
[CLS] who is the better player today ? kobe bryant or [MASK] [SEP]	Carmelo Anthony	Q129041	better
[CLS] let me clear up this kobe is better than [MASK] assumption ? [SEP]	LeBron	Q36159	better
[CLS] is any other kobe fan finding it very very difficult to say kobe is better than [MASK] [SEP]	Lebron	Q36159	better
[CLS] whose a better scorer : [MASK] or kevin duran ##t ? [SEP]	Carmelo Anthony	Q129041	shooting
[CLS] is it a sad day in the section when people claim that not only is [MASK] a better shot than kobe because , , , , , ? [SEP]	Lebron	Q36159	shooting
[CLS] true or false : is it true [MASK] has more final mvp ##s then kobe bryant ? [SEP]	Michael Jordan	Q41421	other
[CLS] who is a better basketball ##er [MASK] or kobe bryant ? [SEP]	Lebron James	Q36159	better
[CLS] who is the better defender [MASK] or joe du ##mar ##s ? [SEP]	Gary Payton	Q309872	defence
[CLS] who ' s had a better overall career in their first seven years ? [MASK] or le ##bron james ? [SEP]	Allen Iverson	Q190094	career
[CLS] who is better tyre ##ke evans or [MASK] [SEP]	Stephen Curry	Q352159	better
[CLS] who is a better basketball player [MASK] or kobe bryant ? [SEP]	tracy mcgrady	Q202295	better
[CLS] who has more talent [MASK] or kobe ? [SEP]	lebron	Q36159	other
[CLS] is [MASK] officially better than tyre ##ke evans and dem ##ar do ##re ##zon ? [SEP]	James Harden	Q136678	better
[CLS] nba : buy or sell : isn ##t it annoying when people say prime kobe is better than [MASK] kobe fans are scared ? [SEP]	lebron	Q36159	other
[CLS] do you think [MASK] is upset because kobe is better than he was ? [SEP]	Michael Jordan	Q41421	better
[CLS] who is the better player kobe or [MASK] [SEP]	lebron	Q36159	better
[CLS] who is closer to reaching m ##j status kobe or [MASK] [SEP]	Lebron	Q36159	other
[CLS] after this game can [MASK] now be said that he is better than kobe ? [SEP]	Lebron	Q36159	better
[CLS] why do some lake ##r fans think kobe is better then [MASK] [SEP]	Jordan	Q41421	better
[CLS] who have the better season next year [MASK] or kobe bryant ? [SEP]	Lebron James	Q36159	season
[CLS] who is better [MASK] or paul pierce ? [SEP]	Carmelo Anthony	Q129041	better
[CLS] what makes [MASK] better than zach randolph ? [SEP]	Pau Gasol	Q193052	better
[CLS] kobe vs [MASK] who ##s better ? [SEP]	LeBron	Q36159	better
[CLS] who ' s the better shot block ##er ? [MASK] or josh smith ? ? [SEP]	marcus camby	Q361134	defence
[CLS] isn ' t it ironic that hate ##rs say [MASK] is better than kobe ? [SEP]	Lebron	Q36159	better
[CLS] who would you consider a better player kobe bryant or [MASK] [SEP]	LeBron James	Q36159	better
[CLS] has [MASK] done more with his nba fame and money then kobe bryant ? [SEP]	Mutumbo	Q313481	other
[CLS] how is [MASK] a better overall player than kobe when he can ##t shoot , post , or defend better than kobe ? [SEP]	lebron	Q36159	better
[CLS] who is a better overall player , [MASK] or kobe bryant ? [SEP]	Dwyane Wade	Q31683	better
[CLS] who has better defense kobe or [MASK] [SEP]	lebron	Q36159	defence
[CLS] so does today ' s lakers win over miami puts to rest that kobe is a better player than [MASK] [SEP]	Dwyane Wade	Q31683	better
[CLS] who will score more this year , kobe bryant or [MASK] [SEP]	LeBron James	Q36159	shooting
[CLS] so will have a better career , [MASK] or michael bea ##sley ? [SEP]	Derrick Rose	Q205326	career
[CLS] will kobe bryant pass up [MASK] by winning more nba championship rings than him ? [SEP]	Michael Jordan	Q41421	other
[CLS] who is stronger kobe bryant or [MASK] [SEP]	tracy mcgrady	Q202295	strength
[CLS] who will have a better nba finals : [MASK] or kobe bryant ? [SEP]	Rajon Rondo	Q274469	other
[CLS] kobe played a med ##io ##cre game overall in the recent finals . [MASK] played better . true or false ? [SEP]	Paul Gasol	Q193052	other
[CLS] why espn said that [MASK] is better than kobe bryant ? [SEP]	LeBron James	Q36159	better
[CLS] why do people like to call kobe a ball hog when pound for pound [MASK] is a bigger ball hog than him ? [SEP]	LeBron	Q36159	other
[CLS] who is more clutch , [MASK] or kobe bryant ? ( nba clutch tournament final round ! ) ? [SEP]	Dirk Nowitzki	Q44068	clutch
[CLS] why do people call [MASK] a better dun ##ker than kobe ? [SEP]	michael Jordan	Q41421	dunking
[CLS] who was a better dun ##ker [MASK] or dominique wilkins ? [SEP]	Julius Erving	Q209921	dunking
[CLS] who is a better defender , kobe bryant or [MASK] [SEP]	Lebron James	Q36159	defence
[CLS] kobe is more clutch than [MASK] why ? [SEP]	Lebron	Q36159	clutch
[CLS] who do you think is better kobe bryant or [MASK] people always make a da ##bate about it ? [SEP]	lebron james	Q36159	better
[CLS] who will go down as the better player in the end > kobe or [MASK] [SEP]	lebron	Q36159	better
[CLS] does [MASK] look taller than big show or is it just me ? [SEP]	Shaq	Q169452	height
[CLS] who ' s better ? dwight howard or [MASK] [SEP]	shaq	Q169452	better
[CLS] is [MASK] a better 3 point shooter than reggie miller ? [SEP]	Ray Allen	Q208623	shooting
[CLS] who will have a better career anthony davis or [MASK] [SEP]	Damian Lillard	Q622308	career
[CLS] who was more dominant at their respective positions , michael jordan or [MASK] [SEP]	Wilt Chamberlain	Q182455	importance
[CLS] who ' s more clutch [MASK] or jordan ? [SEP]	kobe	Q25369	clutch
[CLS] who ' s better and why bill russell or [MASK] [SEP]	Michael Jordan	Q41421	better
[CLS] who will be more important to their team in the next 3 - 4 seasons , raj ##on ron ##do or [MASK] [SEP]	Chris Paul	Q46040	importance
[CLS] who had a better overall career ? [MASK] or karl malone ? [SEP]	Charles Barkley	Q192707	career
[CLS] who is better bill russell or [MASK] [SEP]	larry bird	Q190152	better
[CLS] [MASK] or kevin duran ##t a better shooter ? [SEP]	LeBron	Q36159	shooting
[CLS] who has a better chance of getting mvp : [MASK] kobe , or wade ? [SEP]	Lebron	Q36159	other
[CLS] who is better [MASK] or paul pierce ( in their prime ##s ) ? [SEP]	ray allen	Q208623	better
[CLS] is [MASK] more closer to being the next jordan than kobe ? [SEP]	Lebron	Q36159	other
[CLS] do ##you think kobe is comparable to [MASK] more then jordan ? [SEP]	Scottie Pippen	Q193637	other
[CLS] who would be a better fit for the dallas mavericks this off - season , der ##on williams or [MASK] [SEP]	Deron Williams	Q298496	athletic
[CLS] do people seriously think the kobe was more important than [MASK] ? [SEP]	Shaq	Q169452	other
[CLS] do people seriously think dat kobe is better than [MASK] [SEP]	LeBron	Q36159	better
[CLS] who ' s triple double was better , kobe bryant ' s ( 1 - 31 - 08 , tonight ##s ) or [MASK] s ( 11 - 25 - 07 ) [SEP]	Lebron James	Q36159	other
[CLS] who ' s a better dun ##ker [MASK] or nate robinson ? [SEP]	Lebron	Q36159	dunking
[CLS] who ' s more under ##rated : nicolas bat ##um or [MASK] ? [SEP]	Draymond Green	Q2614593	popularity
[CLS] kobe has had more bad playoff moments than [MASK] but yet dirk gets labeled the choke ##r , why the double standard ? [SEP]	Kobe	Q25369	other
[CLS] explain how kobe is better than [MASK] [SEP]	LeBron	Q36159	better
[CLS] will [MASK] have a better legacy than kobe when he retire ##s ? [SEP]	Lebron	Q36159	other
[CLS] why don ' t people realize that kobe is just a better basketball player than [MASK] putting rings aside ? [SEP]	LeBron	Q36159	better
[CLS] why do people say kobe is better than [MASK] [SEP]	Lebron	Q36159	better
[CLS] who ' s better : paul pierce or [MASK] [SEP]	Carmelo Anthony	Q129041	better
[CLS] larry bird vs [MASK] who was more clutch ? [SEP]	Magic Johnson	Q134183	clutch
[CLS] who ##s better [MASK] or dwight howard ? [SEP]	Derrick rose	Q205326	better
[CLS] is paul pierce [MASK] s better ? [SEP]	Kobe Bryant	Q25369	better
[CLS] why do alpha wolf thinks that kobe bryant done more then [MASK] at age 28 ? [SEP]	Michael Jordan	Q41421	other
[CLS] will [MASK] be a better player than raj ##on ron ##do . . . . ? [SEP]	Rodney Stuckey	Q517029	better
[CLS] poll : kobe still hated more then [MASK] [SEP]	LeBron	Q36159	other
[CLS] does anyone think [MASK] is better than kobe bryant and is the next m ##j ? ? ? ? [SEP]	lebron	Q36159	better
[CLS] who would you say is a better overall defender [MASK] or kobe bryant ? [SEP]	Lebron James	Q36159	defence
[CLS] will [MASK] be better than current gia ##nnis at 24 ? [SEP]	Ben Simmons	Q18638003	better
[CLS] who ##s a better basketball player steve nash or [MASK] [SEP]	ray allen	Q208623	better
[CLS] who ' s a better basketball player overall : kobe bryant or [MASK] [SEP]	LeBron James	Q36159	better
[CLS] who is better [MASK] or dwight howard ? [SEP]	Tim Duncan	Q193020	better
[CLS] do you think kobe bryant is better than [MASK] [SEP]	Tracy McGrady	Q202295	better
[CLS] who ' s the better mvp candidate kobe or [MASK] [SEP]	LeBron	Q36159	other
[CLS] harder player to guard : [MASK] or 2006 kobe bryant ? [SEP]	Carmelo Anthony	Q129041	other
[CLS] [MASK] or je ##rma ##ine o ' neal , who is a better dun ##ker ? ? [SEP]	Jermaine O'neal	Q313499	dunking
[CLS] who has more rings my favorite player [MASK] or joe johnson or le ##hog james ? [SEP]	Stephen Jackson	Q461825	shooting
[CLS] which game displayed more talent , [MASK] 69 or kobe bryant ' s 81 ? [SEP]	Michael Jordan's	Q41421	other
[CLS] who has better foot ##work ? kobe or [MASK] [SEP]	Michael jordan	Q41421	other
[CLS] who is a better basketball player overall ? [MASK] or carmel ##o anthony ? [SEP]	Dwayne Wade	Q31683	better
[CLS] if kobe bryant wins more championships than [MASK] does that make him better ? [SEP]	michael jordan	Q41421	other
[CLS] who ##s dun ##k was better : [MASK] cup ##cake dun ##k or dwight howard ##s superman dun ##k ? [SEP]	Gerald Greens	Q722629	better
[CLS] who is more over ##rated [MASK] or ka ##ree ##m abdul ja ##bba ##r ? [SEP]	Wilt Chamberlain	Q182455	popularity
[CLS] who is better ? [MASK] or paul pierce ? [SEP]	lebron james	Q36159	better
[CLS] which player is more dominant ? [MASK] or le ##bron ? [SEP]	Kobe	Q25369	importance
[CLS] who has better career steve nash or [MASK] why ? [SEP]	allen iverson	Q190094	career
[CLS] was [MASK] a better jump shooter then blake griffin in his 2nd season ? [SEP]	Karl Malone	Q199896	shooting
[CLS] why does everybody say [MASK] is better than kobe ? [SEP]	Lebron	Q36159	better
[CLS] who has had a better nba career : steve nash or [MASK] [SEP]	Jason Kidd	Q221341	career
[CLS] who is a better player [MASK] or steve nash ? ? [SEP]	Jason Kidd	Q221341	better
[CLS] do you think carmel ##o anthony is better than [MASK] [SEP]	LeBron James	Q36159	better
[CLS] to all you [MASK] fans saying he is better than kobe , saying he has better stats . . so chamber ##lin > m ##j ? [SEP]	lebron	Q36159	better
[CLS] more un ##guard ##able in his prime : [MASK] or kobe bryant ? [SEP]	LeBron James	Q36159	other
[CLS] [MASK] or kobe who had better all ##rou ##nd game ? [SEP]	Mj	Q41421	other
[CLS] who is a bigger ball ##hog . . . . kobe or [MASK] [SEP]	Iverson	Q190094	other
[CLS] is dwight howard more clutch than [MASK] [SEP]	lebron	Q36159	clutch
[CLS] do you agree with me when i say that paul pierce is way better than [MASK] [SEP]	Bryant	Q25369	better
[CLS] who ' s better shooter ? al harrington or [MASK] [SEP]	marvin williams	Q517058	shooting
[CLS] who is better right now ? dem ##ar der ##oza ##n or [MASK] [SEP]	Carmelo Anthony	Q129041	better
[CLS] who is a better basketball player kobe bryant or [MASK] [SEP]	Lebron James	Q36159	better
[CLS] whose a better nba player : [MASK] or carmel ##o anthony ? [SEP]	Kevin Durant	Q29545	better
[CLS] who ' s better paul pierce or [MASK] [SEP]	jr smith	Q669334	better
[CLS] was michael jordan more important to the bulls then what [MASK] is for the suns ? [SEP]	Steve Nash	Q192955	importance
[CLS] why do heat fans always mention [MASK] being better then kobe ? [SEP]	Lebron	Q36159	better
[CLS] who was the better clutch shooter ? [MASK] or kobe bryant ? [SEP]	Robert Horry	Q364394	shooting
[CLS] who makes more money - [MASK] or kobe bryant ? [SEP]	Lebron James	Q36159	other
[CLS] who ' s a better shooter : prime [MASK] or kevin duran ##t ? [SEP]	Kevin Durant	Q29545	shooting
[CLS] is kobe better player than [MASK] [SEP]	shaq	Q169452	better
[CLS] [MASK] with 52 points , 11 assists , and 10 rebounds . . . triple double . . . better than kobe ' s 61 . . . i think . . . you ? [SEP]	LeBron	Q36159	better
[CLS] who do you think has a better career vince carter or [MASK] [SEP]	Tracy McGrady	Q202295	career
[CLS] who is faster : [MASK] or john wall ? [SEP]	Lebron James	Q36159	athletic
[CLS] career wise , who do you think will be the better player when its all said and done , kobe or [MASK] [SEP]	lebron	Q36159	better
[CLS] who ' s a bigger ball - hog , [MASK] or steve nash ? [SEP]	Kobe Bryant	Q25369	other
[CLS] does espn ' s jem ##ele hill still think kobe bryant is better than [MASK] [SEP]	Michael Jordan	Q41421	better
[CLS] who is faster ? [MASK] or john wall ? [SEP]	Derrick Rose	Q205326	athletic
[CLS] if they retired today who would be seen as the better all time player kobe or [MASK] [SEP]	Lebron	Q36159	better
[CLS] who ' s stronger [MASK] or le ##bron james ? [SEP]	Blake Griffin	Q309783	strength
[CLS] who is the better long range shooter [MASK] or kobe bryant ? [SEP]	Micheal Jordan	Q41421	shooting
[CLS] who is better paul pierce or [MASK] [SEP]	Tracy McGrady	Q202295	better
[CLS] who do you think is a better basketball player alive now : [MASK] or kobe bryant ? [SEP]	Lebron James	Q36159	better
[CLS] who ' s a better dun ##ker [MASK] or le ##bron ? [SEP]	Kobe	Q25369	dunking
[CLS] who do you guys think is better andre i ##gu ##oda ##la or [MASK] [SEP]	Andre Iguodala	Q136816	better
[CLS] who has a better judge of talent , [MASK] fans or kobe bryant fans ? [SEP]	Michael Jordan	Q41421	other
[CLS] ca ##vs lose to orlando , if la beats orlando will this finally prove kobe is better than [MASK] [SEP]	Lebron	Q36159	better
[CLS] kobe or [MASK] who a better wide receiver ? [SEP]	Lebron	Q36159	other
[CLS] who is a better scorer , [MASK] or james harden ? [SEP]	Kyrie Irving	Q348618	shooting
[CLS] why would anyone think that kobe is better than [MASK] [SEP]	MJ	Q41421	better
[CLS] why do people think that kobe bryant still have a chance at accomplish ##ing more then [MASK] [SEP]	Michael Jordan	Q41421	other
[CLS] lake ##r fans , whose a better all time lake ##r , kobe bryant or [MASK] [SEP]	Lewis Alcindor	Q179051	better
[CLS] disregard stats , career accomplishments , everything . skill set wise , who is better , [MASK] or kobe ? [SEP]	MJ	Q41421	better
[CLS] who had greater help during their days together : m ##j from scott ##ie or [MASK] from kobe ? [SEP]	Shaq	Q169452	other
[CLS] who ' s better block ##er ? kobe , [MASK] or wade ? [SEP]	lebron	Q36159	defence
[CLS] who ##s a better player kobe bryant or [MASK] [SEP]	michael jordan	Q41421	better
[CLS] who is a better dun ##ker [MASK] or blake griffin ? [SEP]	Vince Carter	Q241261	dunking
[CLS] why do people seem to think kobe bryant is better than [MASK] was ? [SEP]	Magic Johnson	Q134183	better
[CLS] why is derrick rose already a better shooter than [MASK] [SEP]	Lebron James	Q36159	shooting
[CLS] how has kobe bryant already played more games than [MASK] [SEP]	Michael Jordan	Q41421	other
[CLS] does steve nash [MASK] and howard fit better than the heats big 3 ? [SEP]	Kobe	Q25369	athletic
[CLS] who ' s more under ##rated , michael red ##d or [MASK] [SEP]	Tayshaun Prince	Q295521	popularity
[CLS] raj ##on ron ##do or [MASK] better player ? [SEP]	Derrick Rose	Q205326	better
[CLS] who ' s better , kg , duncan , amar ##e , e . brand , d . howard , by ##num , [MASK] b . wallace , r . wallace , webber , j . one ##al [SEP]	C. Bosh	Q201386	better
[CLS] who is better skill - wise aka foot ##work jumper post moves etc [MASK] or kobe ? [SEP]	MELO	Q129041	other
[CLS] this will determine who is better . . . [MASK] or kobe . . . answer each with honesty ? [SEP]	LeBron	Q36159	better
[CLS] who was a bigger bust adam morrison or [MASK] [SEP]	Jared Jeffries	Q681243	strength
[CLS] who ##s better paul pierce or [MASK] [SEP]	Kobe Bryant	Q25369	better
[CLS] who is better defender gerald wallace or [MASK] [SEP]	Lebron james	Q36159	defence
[CLS] who will have a better season next year . jeremy lin or [MASK] [SEP]	Goran Dragic	Q369532	season
[CLS] do you agree with me when i say that [MASK] is way better than bryant ? [SEP]	Paul Pierce	Q121647	better
[CLS] do you think [MASK] is better than kobe after the 4 ##rd mvp ? [SEP]	Lebron	Q36159	better
[CLS] who was a better point guard in their prime [MASK] or nick van ex ##el ? [SEP]	Derek Fisher	Q314621	defence
[CLS] find out here why [MASK] is way better than kobe . ? [SEP]	Lebron james	Q36159	better
[CLS] bigger bust , sebastian tel ##fa ##ir or [MASK] [SEP]	Shaun Livingston	Q555264	strength
[CLS] why would anybody who actually knows basketball deny the fact that kobe bryant is way more skilled than [MASK] [SEP]	LeBron	Q36159	other
[CLS] why do people think kobe is better than [MASK] [SEP]	michael jordan	Q41421	better
[CLS] who do you think is stranger [MASK] or scott pollard ? [SEP]	Drew Gooden	Q370006	other
[CLS] does [MASK] look taller than steve nash to you ? [SEP]	Devin Harris	Q358102	height
[CLS] kobe bragg ##ing that he has more rings than [MASK] ? really kobe ? [SEP]	Shaq	Q169452	shooting
[CLS] who ' s better , [MASK] or bill russell ? [SEP]	Michael Jordan	Q41421	better
[CLS] who is a better nba player : [MASK] or kobe bryant ? [SEP]	LeBron James	Q36159	better
[CLS] who ' s more clutch kobe or [MASK] [SEP]	paul pierce	Q121647	clutch
[CLS] was bill russell better than [MASK] [SEP]	Lebron James	Q36159	better
[CLS] [MASK] vs kobe who ##s better ? [SEP]	Lebron	Q36159	better
[CLS] lin ##san ##ity vs [MASK] who the better point guard right now ? ? ? [SEP]	cp3	Q46040	defence
[CLS] isn ' t [MASK] better than dwight howard for these reasons ? [SEP]	Yao Ming	Q58590	better
[CLS] who is better : [MASK] in orlando and first year in la or dwight howard ? [SEP]	Shaq	Q169452	better
[CLS] spiritual ##ly speaking : who is a better basketball player kobe or [MASK] [SEP]	Lebron	Q36159	better
[CLS] who was a bigger bust [MASK] or jared jeff ##ries ? [SEP]	Adam Morrison	Q350464	strength
[CLS] you vote who ' s better kobe bryant or [MASK] [SEP]	Lebron James	Q36159	better
[CLS] who is a better 3 ##pt shooter ? [MASK] or o . j . mayo ? [SEP]	Mike Bibby	Q311542	shooting
[CLS] who had the better supporting cast ? [MASK] 09 - 10 or kobe 05 - 06 ? [SEP]	Lebron	Q36159	other
[CLS] who is a better perimeter defender : [MASK] or bruce bowen ? [SEP]	Michael Jordan	Q41421	defence
[CLS] was kobe a better player with [MASK] ? ? ? ? [SEP]	Shaq	Q169452	better
[CLS] can gerald green jump higher then [MASK] [SEP]	Vince carter	Q241261	height
[CLS] is it only kobe fans or [MASK] hate ##rs who say kobe is better ? [SEP]	Lebron	Q36159	better
[CLS] who is stronger and buffer ? le ##bron james or [MASK] [SEP]	Kobe Bryant	Q25369	strength
[CLS] kobe vs [MASK] ok everyone says jordan has better stats than kobe because jordan has a better team . ? [SEP]	Kobe	Q25369	other
[CLS] if kobe bryant wins his 4th title this year , is he back in the better then [MASK] conversation ? [SEP]	Jordan	Q41421	better
[CLS] kobe or [MASK] ? ? who is more talented ? [SEP]	Lebron	Q36159	other
[CLS] will [MASK] be a better player than kobe and possibly jordan by the time he retire ##s ? [SEP]	Lebron	Q36159	better
[CLS] anyone else think [MASK] s 73 point game is better than kobe ' s 81 ? [SEP]	David Thompson	Q718669	better
[CLS] why do kobe fans think kobe is a better jump shooter than [MASK] [SEP]	lebron	Q36159	shooting
[CLS] true or false : [MASK] won a championship without kobe bryant earlier then kobe bryant did ? [SEP]	Shaq	Q169452	other
[CLS] who choked worse , kobe or [MASK] [SEP]	LeBron	Q36159	other
[CLS] is kobe real ##y that much more clutch than [MASK] look at this ! ! ? [SEP]	LeBron	Q36159	clutch
[CLS] i ' m still trying to figure out why [MASK] 1 ) isn ' t considered better than kobe ( 5 ) bryant ? [SEP]	Dwayne Wade	Q31683	better
[CLS] who is the better player today ? [MASK] or carmel ##o anthony ? [SEP]	Carmelo Anthony	Q129041	better
[CLS] whose more gangs ##ta paul pierce or [MASK] ! ? [SEP]	Carmelo Anthony	Q129041	other
[CLS] tell me why kobe is better than [MASK] [SEP]	LeBron	Q36159	better
[CLS] who is better [MASK] or paul pierce ? [SEP]	Lebron James	Q36159	better
[CLS] who is a better shooter steve nash or [MASK] [SEP]	Kobe Bryant	Q25369	shooting
[CLS] since [MASK] fans use stats to say he ##s better than kobe will it be obvious that kobe ##s better next season ? [SEP]	Lebron	Q36159	other
[CLS] who is more over ##rated . . . [MASK] or kobe bryant ? [SEP]	Lebron James	Q36159	popularity
[CLS] who ' s better [MASK] or d . howard ? [SEP]	Shaq	Q169452	better
[CLS] can you give me at least 5 or more reasons why [MASK] is better than kobe bryant ? [SEP]	lebron james	Q36159	better
[CLS] who had a better supporting cast kobe in 2009 or [MASK] in 2003 ? [SEP]	Tim Duncan	Q193020	other
[CLS] bigger bust [MASK] or anthony bennett ? [SEP]	Kwayme Brown	Q317037	strength
[CLS] what was more amazing , [MASK] foul - line dun ##k or kobe bryant jumping over the aston martin ( car ) ? [SEP]	Michael Jordan's	Q41421	other
[CLS] who ##s better [MASK] one ##il or kobe bryant ? ? ? ? ? [SEP]	shaquille	Q169452	better
[CLS] will le ##bron james win more championships than [MASK] or will it be kobe ? [SEP]	jordan	Q41421	career
[CLS] do [MASK] deserve to to be rated higher than kobe in 2 ##k ##13 ? [SEP]	Dwight Howard	Q25278	other
[CLS] who was a better basketball player [MASK] or dominique wilkins ? [SEP]	Clyde Drexler	Q295340	better
[CLS] who is better ? dwight howard vs . [MASK] [SEP]	Amare Stoudemire	Q270981	better
[CLS] prime [MASK] or current carmel ##o anthony ? who do you think is better and rather have on a team ? [SEP]	Ron Artest	Q295322	better
[CLS] who had a better regular season kobe or [MASK] [SEP]	D Wade	Q31683	season
[CLS] ok , let ' s be very honest with ourselves , who would be better in dun ##king ? kobe or [MASK] [SEP]	Jordan	Q41421	dunking
[CLS] is this a reason why [MASK] has better stats then kobe ? [SEP]	LeBron	Q36159	other
[CLS] who is stronger mentally , le ##bron james or [MASK] [SEP]	Dwayne Wade	Q31683	strength
[CLS] who has the better shooting form [MASK] or kobe bryant ? [SEP]	Carmelo Anthony	Q129041	shooting
[CLS] who ' s more athletic [MASK] or russell west ##brook ? [SEP]	Derrick Rose	Q205326	athletic
[CLS] who was a better shooter reggie miller or [MASK] [SEP]	larry bird	Q190152	shooting
[CLS] who ##s is better [MASK] or paul pierce ? [SEP]	allen iverson	Q190094	better
[CLS] who is better [MASK] or kobe ? [SEP]	ginobili	Q213132	better
[CLS] [MASK] vs magic johnson : who was more clutch ? [SEP]	Larry Bird	Q190152	clutch
[CLS] who is a better shooter [MASK] or d ##wy ##ane wade ? [SEP]	Lebron James	Q36159	shooting
[CLS] who is a better overall basketball player , [MASK] or kobe bryant ? [SEP]	Dwyane Wade	Q31683	better
[CLS] who had a better career ; robert ho ##rry or [MASK] [SEP]	Karl Malone	Q199896	career
[CLS] who will be considered the greater player in the end - [MASK] or kobe ? [SEP]	Shaq	Q169452	other
[CLS] who do you think is the better pg , steve nash or [MASK] [SEP]	J-Kidd	Q221341	other
[CLS] who travels more : [MASK] or kobe ? [SEP]	Lebron	Q36159	other
[CLS] kobe or [MASK] whose the better player ? [SEP]	Lebron	Q36159	better
[CLS] would you say kobe is more skilled than [MASK] [SEP]	Michael Jordan	Q41421	other
[CLS] [MASK] is a better clutch shooter than kobe ? [SEP]	LeBron	Q36159	shooting
[CLS] who handles the ball more [MASK] or kobe bryant ? [SEP]	Jason Kidd	Q221341	other
[CLS] why i have the feeling that both wade and [MASK] are better than kobe ? [SEP]	James	Q36159	better
[CLS] kobe vs [MASK] who is better at each thing ( everyone please answer ) ? [SEP]	LeBron	Q36159	other
[CLS] who do you think will have a better season next year ? roy hi ##bber ##t or [MASK] [SEP]	Greg Monroe	Q611372	season
[CLS] whom plays better basketball today kobe or [MASK] [SEP]	lebron	Q36159	better
[CLS] non - lake ##r fans : do you think kobe bryant is better then [MASK] [SEP]	Micheal Jordan	Q41421	better
[CLS] who ' s a bigger bust ? [MASK] dark ##o , or adam morrison ? [SEP]	Kwame Brown	Q317037	strength
[CLS] who is better kobe by ##rant or [MASK] [SEP]	lebron james	Q36159	better
[CLS] who would you trust more in the clutch kobe bryant or [MASK] and why ? [SEP]	LeBron James	Q36159	other
[CLS] did kobe bryant have a higher vertical jump than [MASK] in his prime years ? [SEP]	Lebron James	Q36159	other
[CLS] who has better leadership : [MASK] or kobe ? [SEP]	LeBron	Q36159	other
[CLS] does anyone still believe [MASK] is better then kobe ? [SEP]	Lebron	Q36159	better
[CLS] who is a better basketball player kobe bryant or [MASK] ? [SEP]	dwayne wade	Q31683	better
[CLS] who ' s better rookie kobe or rookie [MASK] [SEP]	lebron	Q36159	better
[CLS] [MASK] vs prime kobe bryant : better player ? [SEP]	Kevin Durant	Q29545	better
[CLS] how is kobe better than [MASK] i just don ' t get it ? [SEP]	Lebron	Q36159	better
[CLS] is kobe a better 3 point shooter and overall better shooter than [MASK] [SEP]	Ray Allen	Q208623	shooting
[CLS] is dwight howard better than [MASK] [SEP]	Jermaine O'Neal	Q313499	better
[CLS] do people realize the many reasons why kobe is way better than [MASK] [SEP]	Lebron	Q36159	better
[CLS] if [MASK] said paul pierce is better than him , what do you say ? [SEP]	LeBron	Q36159	better
[CLS] if kobe and [MASK] switched teams which would be better which would be worse ? [SEP]	lebron	Q36159	other
[CLS] why do people insist that [MASK] is better than kobe ? [SEP]	Michael Jordan	Q41421	better
[CLS] who is going to have a better career [MASK] or kobe ? [SEP]	Lebron	Q36159	career
[CLS] who is a better basketball player kobe bryant or [MASK] [SEP]	micheal jordan	Q41421	better
[CLS] who is better dwight howard or [MASK] [SEP]	Dirk Nowitzki	Q44068	better
[CLS] who was more athletic at 23 - dwight howard or [MASK] [SEP]	shaq	Q169452	athletic
[CLS] who is a better nba player kobe bryant or [MASK] [SEP]	Lebron James	Q36159	better
[CLS] why do you think kobe bryant is better than [MASK] [SEP]	Michael Jordan	Q41421	better
[CLS] basketball : who is better overall : prime [MASK] or prime kobe ? [SEP]	Iverson	Q190094	better
[CLS] do more people know [MASK] or kobe ? + b ##q ? [SEP]	Shaq	Q169452	other
[CLS] is kobe bryant a better player than [MASK] [SEP]	Brian Scalabrine	Q459471	better
[CLS] who has kissed there teammates on the lips more often kobe bryant or [MASK] [SEP]	Lebron James	Q36159	other
[CLS] does anyone else agree with me that [MASK] is way better than kobe bryant ? [SEP]	trevor ariza	Q358108	better
[CLS] kobe bryant or [MASK] who do you think was the better player back in 2006 ? [SEP]	Dwayne Wade	Q31683	better
[CLS] will [MASK] end his career with more championships than kobe bryant ? [SEP]	Lebron James	Q36159	other
[CLS] if [MASK] wins 3 nba finals mvp ' s , should he be considered better than kobe ? [SEP]	LeBron	Q36159	better
[CLS] if [MASK] would have won back to back rings ( along with his mvp ' s ) , would people see him as better than kobe ? [SEP]	Lebron	Q36159	better
[CLS] who do you think is better kobe bryant or [MASK] [SEP]	LeBron James	Q36159	better
[CLS] who is more loved , [MASK] or paul pierce ? [SEP]	Kobe Bryant	Q25369	other
[CLS] who is more intelligent , [MASK] or kobe ? [SEP]	leBron	Q36159	other
[CLS] nba : why do people still think today ' s kobe is better than today ' s [MASK] [SEP]	Wade	Q31683	better
[CLS] who is richer [MASK] or magic johnson ? [SEP]	Michael Jordan	Q41421	money
[CLS] who ball hog ##s more ? kobe or [MASK] or carmel ##lo ? nba ? [SEP]	Lebron	Q36159	other
[CLS] why do lakers fan compare kobe 4 rings to [MASK] to say he is better even though kobe had better teams ? [SEP]	Lebron	Q36159	better
[CLS] seth curry is way better then [MASK] [SEP]	LeBron james	Q36159	better
[CLS] who was the better athlete : [MASK] or michael jordan ? [SEP]	Jim Thorpe	Q221482	athletic
[CLS] are [MASK] jumping higher than kobe ? [SEP]	paul pierce	Q121647	other
[CLS] who is better dun ##ker le ##bron james or [MASK] [SEP]	Blake Griffin	Q309783	dunking
[CLS] who is better [MASK] or dwight howard . and why do you think this ? [SEP]	Lebron James	Q36159	better
[CLS] who ##s a better basketball player [MASK] or kobe ? [SEP]	lebron	Q36159	better
[CLS] who ' s more over ##rated yao ming or [MASK] [SEP]	Steve Nash	Q192955	popularity
[CLS] who has a better mid - range game ? [MASK] or paul pierce ? [SEP]	Kobe	Q25369	other
[CLS] who ' s better ? [MASK] or dwight howard ? [SEP]	bynum	Q314822	better
[CLS] is [MASK] a better dun ##ker than josh smith ? [SEP]	Vince Carter	Q241261	dunking
[CLS] who ' s faster allen iv ##erson ( at his fastest ) or [MASK] [SEP]	ty lawson	Q520368	athletic
[CLS] y is kobe considered greatest ever when he only has two finals mvp ' s [MASK] and magic even have more as a lake ##r . ? [SEP]	shaq	Q169452	other
[CLS] who is taller [MASK] or michael jordan ? [SEP]	kobe bryant	Q25369	height
[CLS] who ##s a better player : kobe or [MASK] [SEP]	LeBron	Q36159	better
[CLS] [MASK] 11 for 11 last game , kobe missed lay ##up , dun ##k , lay ##up , who was better ? [SEP]	LeBron	Q36159	other
[CLS] who ' s stronger le ##bron james or [MASK] [SEP]	dwight howard	Q25278	strength
[CLS] more over ##rated as a defender [MASK] or ron arte ##st ? [SEP]	Bruce Bowen	Q306553	popularity
[CLS] who is the better scorer kobe or [MASK] [SEP]	lebron	Q36159	shooting
[CLS] who is taller [MASK] or shawn bradley ? [SEP]	Yao Ming	Q58590	height
[CLS] who do you think was a better player in their prime ##s ? kobe bryant or [MASK] [SEP]	Allen Iverson	Q190094	better
[CLS] i admit it . . os ##iri ##s . carmel ##o anthony is a way better player than [MASK] ? [SEP]	Carmelo Anthony	Q129041	better
[CLS] does it really make [MASK] better than kobe if the ca ##vs beat la in the finals , and vice versa ? [SEP]	Lebron	Q36159	better
[CLS] why kobe fans only use rings as why kobe is better than [MASK] [SEP]	Lebron	Q36159	better
[CLS] who is a better shooter derrick rose or [MASK] [SEP]	LeBron James	Q36159	shooting
[CLS] who do you think is better kobe bryant or [MASK] why ? [SEP]	lebron james	Q36159	better
[CLS] who is more important to the suns nash or [MASK] [SEP]	Stoudemire	Q270981	importance
[CLS] who is a better defender kobe bryant or [MASK] [SEP]	LeBron James	Q36159	defence
[CLS] who is better dun ##ker [MASK] or blake griffin ? [SEP]	LeBron James	Q36159	dunking
[CLS] so does kobe ' s 4th ring proves that he is better than [MASK] [SEP]	shaq	Q169452	better
[CLS] who is a better pure shooter : kobe bryant or [MASK] [SEP]	Dirk Nowitzki	Q44068	shooting
[CLS] why does espn and the media hide the fact that steve nash is better than [MASK] [SEP]	Michael jordan	Q41421	better
[CLS] [MASK] and k . bryant who is a better player ? [SEP]	L.James	Q36159	better
[CLS] explain to me why kobe bryant is a better basketball player than [MASK] [SEP]	LeBron James	Q36159	better
[CLS] would more people watch the nba finals if kobe was in it or [MASK] [SEP]	Lebron	Q36159	other
[CLS] who is a better basketball player , kobe or [MASK] [SEP]	Lebron	Q36159	better
[CLS] better for fantasy basketball dwight howard or [MASK] [SEP]	Pau Gasol	Q193052	better
[CLS] who ' s a better defender . . . ron arte ##st or [MASK] ? [SEP]	Bruce Bowen	Q306553	defence
[CLS] who has more rings my favorite player stephen jackson or [MASK] or le ##hog james ? [SEP]	Joe Johnson	Q132208	shooting
[CLS] what stat ##istic is more under ##rated , [MASK] s rebound ##ing or jam ##eer nelson passing ? [SEP]	nikola vucevic	Q659886	other
[CLS] who ' s taller in this pic , [MASK] or big ##sho ##w ? [SEP]	Shaq	Q169452	height
[CLS] would you say [MASK] is better than kobe ? [SEP]	Lebron	Q36159	better
[CLS] who ' s really better bill russell or [MASK] [SEP]	Wilt Chamberlain	Q182455	better
[CLS] who is better kobe brian ##t or [MASK] [SEP]	baron davis	Q313486	better
[CLS] who was / is a better 3 point shooter reggie miller or [MASK] [SEP]	Ray Allen	Q208623	shooting
[CLS] who would you rather see win a ring and who is more des ##erving steve nash or [MASK] [SEP]	LeBron James	Q36159	other
[CLS] who is a better nba player in your opinion : [MASK] or kobe bryant ? [SEP]	Dwayne Wade	Q31683	better
[CLS] who was more clutch last year ? [MASK] or kobe bryant ? special link for you guys ! ? [SEP]	LeBron James	Q36159	clutch
[CLS] who ' s better [MASK] or prime paul pierce ? [SEP]	Carmelo Anthony	Q129041	better
[CLS] who was the better player , kobe or [MASK] [SEP]	Shaq	Q169452	better
[CLS] who do you think is better wade , [MASK] or kobe ? [SEP]	Lebron	Q36159	better
[CLS] who do you think is a better play maker [MASK] or steve nash ? [SEP]	Jason Kidd	Q221341	other
[CLS] who has bigger vertical jump ? steve nash or [MASK] ? [SEP]	Nate Robinson	Q315104	other
[CLS] kobe or [MASK] who has a higher career average in ap ##g , rpg , pp ##g , ? [SEP]	Lebron	Q36159	other
[CLS] who ' s a better dun ##ker , [MASK] in his prime or le ##bron james ? [SEP]	Vince Carter	Q241261	dunking
[CLS] who is the better scorer kevin duran ##t or [MASK] [SEP]	Lebron James	Q36159	shooting
[CLS] who is the better overall player [MASK] or kobe ? [SEP]	LeBron	Q36159	better
[CLS] stop saying [MASK] is better than kobe ? [SEP]	LeBron	Q36159	better
[CLS] who was more clutch ? larry bird or [MASK] [SEP]	Lebron James	Q36159	clutch
[CLS] who ' s better : [MASK] or dwight howard ? [SEP]	Amare Stoudemire	Q270981	better
[CLS] kobe is way more clutch than [MASK] how can anyone say that le ##bron james is better than kobe bryant ? [SEP]	LeBron	Q36159	clutch
[CLS] have [MASK] already proven to be better then kobe bryant ? [SEP]	Dwyane Wade	Q31683	better
[CLS] do you think rudy gay and andre i ##go ##da ##ula is better than [MASK] i think we should trade deng ? [SEP]	luol deng	Q275183	better
[CLS] who is a better all time player / shooter ? reggie miller or [MASK] [SEP]	ray allen	Q208623	shooting
[CLS] who has more money [MASK] or yao ming ? [SEP]	Shaq	Q169452	money
[CLS] whose taller tay ##sha ##un prince or [MASK] [SEP]	Kevin Durant	Q29545	height
[CLS] who had a better shooting game ? kobe bryant or [MASK] [SEP]	Kevin Durant	Q29545	shooting
[CLS] who was the better clutch player ? kobe or [MASK] [SEP]	Michael Jordan	Q41421	better
[CLS] give me 10 reason why kobe by ##rant is better than le ##born [MASK] right now ? [SEP]	james	Q36159	better
[CLS] who ##s a better dun ##ker , [MASK] of le ##bron ? [SEP]	Gerald green	Q722629	dunking
[CLS] would you say that kobe is better than [MASK] due to the fact that kobe never quit on his team twice ? [SEP]	Michael Jordan	Q41421	better
[CLS] who has more rings brian scala ##bri ##ne or [MASK] [SEP]	dirk nowitzki	Q44068	shooting
[CLS] who had a better career ? [MASK] or karl malone ? [SEP]	Alonzo Mourning	Q310968	career
[CLS] will le ##bron james have a better career than [MASK] [SEP]	kobe bryant	Q25369	career
[CLS] does anybody here still think [MASK] is a better basketball player than kobe ? [SEP]	Lebron James	Q36159	better
[CLS] who ' s more over ##rated : kobe or [MASK] [SEP]	Phil Jackson	Q316246	popularity
[CLS] why do pp ##l think [MASK] is so much better than rudy gay ? [SEP]	joe Johnson	Q132208	better
[CLS] [MASK] says that kobe is a better scorer than m ##j was , is this true ? [SEP]	Phil Jackson	Q316246	shooting
[CLS] nba : who would be a better owner m ##j , [MASK] or kobe ? [SEP]	LeBron	Q36159	other
[CLS] who is faster , john wall or [MASK] [SEP]	Derrick Rose	Q205326	athletic
[CLS] who ' s the better defender right now , shane bat ##tier or [MASK] [SEP]	Tony Allen	Q443412	defence
[CLS] this is why i think [MASK] is better than kobe . . . . any thoughts ? [SEP]	LeBron	Q36159	better
[CLS] who could dun ##k better kobe or [MASK] [SEP]	Lebron	Q36159	dunking
[CLS] i don ' t know if this is a comparison , but why is [MASK] all of a sudden better than kobe ? [SEP]	LeBron	Q36159	better
[CLS] @ king l ##v ##l 4 , how the hell is lu ##ol deng a better defender than [MASK] [SEP]	Paul pierce	Q121647	defence
[CLS] do you think kobe will be considered better than [MASK] after he retire ##s ? [SEP]	Michael Jordan	Q41421	better
[CLS] who looks better out of kobe bryant and [MASK] [SEP]	lebron james	Q36159	other
[CLS] why are so many people convinced that kobe bryant is better than [MASK] michael jordan ? [SEP]	His Airness	Q41421	better
[CLS] is seth curry better than [MASK] [SEP]	Stephen Curry	Q352159	better
[CLS] who do you think is better kobe or [MASK] [SEP]	LeBron	Q36159	better
[CLS] who is a better shooter , [MASK] or steve nash + b ##q ? [SEP]	Kobe Bryant	Q25369	shooting
[CLS] who is better , [MASK] or andre miller ? [SEP]	Devin Harris	Q358102	better
[CLS] who ' s more athletic : russell west ##brook or [MASK] [SEP]	Lebron James	Q36159	athletic
[CLS] who is more dominant sha ##q or [MASK] [SEP]	Shaq	Q169452	importance
[CLS] who is a better defender , kobe or [MASK] [SEP]	LeBron	Q36159	defence
[CLS] if kobe wins his fifth ring this year will he be considered a greater player than [MASK] [SEP]	Magic Johnson	Q134183	other
[CLS] who is taller , magic [MASK] or bird ? [SEP]	Jordan	Q41421	height
[CLS] is [MASK] officially better than dwight howard ? [SEP]	Chris Bosh	Q201386	better
[CLS] who was more impressive while winning their first 4 nba championships , [MASK] or kobe bryant ? [SEP]	Michael Jordan	Q41421	other
[CLS] which current nba player are better in the los angeles lakers - boston celtics rivalry : lo ##nzo ball or [MASK] [SEP]	Kyrie Irving	Q348618	better
[CLS] who is stronger eric gordon or [MASK] [SEP]	Derrick rose	Q205326	strength
[CLS] [MASK] is considered to be the greatest ever , but is kobe bryant better ? [SEP]	Michael Jordan	Q41421	better
[CLS] is [MASK] showing everyday more and more he is better than kobe ? [SEP]	Lebron	Q36159	other
[CLS] who was the better player : dominique wilkins or [MASK] [SEP]	Charles Barkley	Q192707	better
[CLS] at their best , was kobe a better scorer than [MASK] [SEP]	Jordan	Q41421	shooting
[CLS] how much more will you hate ##rs , hate kobe if the lakers get marion or [MASK] [SEP]	Artest	Q295322	other
[CLS] why do people always say [MASK] is better than kobe because he av ##rage more rebounds blocks and assist ? [SEP]	Lebron	Q36159	better
[CLS] who is better [MASK] or paul pierce ? [SEP]	Vince Carter	Q241261	better
[CLS] [MASK] shoots more thank kobe ? [SEP]	Lebron	Q36159	other
[CLS] who do you guys think is better andre i ##gu ##oda ##la or [MASK] that ' s about the hardest question to answer . ? [SEP]	Andre Iguodala	Q136816	better
[CLS] who ' s word do you believe in more , kobe bryant or [MASK] [SEP]	Lebron James	Q36159	other
[CLS] who do you think is better [MASK] or kobe ? [SEP]	LeBron	Q36159	better
[CLS] fantasy games : d . howard trade for [MASK] which player is better ? [SEP]	Yao ming	Q58590	better
[CLS] why do people think kobe is better than [MASK] because he have more rings ? [SEP]	Lebron	Q36159	better
[CLS] explain how kobe is a better player than [MASK] not career ? [SEP]	Lebron	Q36159	better
[CLS] who ' s more washed up . [MASK] or kobe bryant ? [SEP]	Kevin Garnett	Q189240	other
[CLS] who ' s a better defender . . . [MASK] or bruce bowen ? ? [SEP]	Ron Artest	Q295322	defence
[CLS] who is better [MASK] or dwight howard ? [SEP]	Dwyane Wade	Q31683	better
[CLS] who is a better shooter : kobe or [MASK] [SEP]	Lebron	Q36159	shooting
[CLS] who was a better duo [MASK] and kobe or m ##j and pip ##pen ? [SEP]	Shaq	Q169452	other
[CLS] nba : who do you think will have a better nba career : [MASK] or michael bea ##sley ? [SEP]	Blake Griffin	Q309783	career
[CLS] who ' s the more pure pg steve nash or [MASK] [SEP]	Rajon Rondo	Q274469	other
[CLS] who is more athletic blake griffin or [MASK] [SEP]	Dwight Howard	Q25278	athletic
[CLS] do you agree with me : kobe bryant is better than [MASK] [SEP]	LeBron James	Q36159	better
[CLS] who would be a better soccer player kobe bryant or [MASK] [SEP]	Steve Nash	Q192955	better
[CLS] who ##s better [MASK] on fire or kobe on fire ? [SEP]	mj	Q41421	better
[CLS] ryan anderson or [MASK] who do u think will have a better season ? [SEP]	Varejao	Q363445	season
[CLS] can anyone explain to me why kobe is better than [MASK] [SEP]	Lebron	Q36159	better
[CLS] still think [MASK] is better than kobe ? [SEP]	Lebron	Q36159	better
[CLS] who would be a better fit for the lakers ? der ##on williams ? ? or [MASK] [SEP]	Chris Paul	Q46040	athletic
[CLS] who has scored more points in one game dirk , [MASK] or kobe ? [SEP]	Lebron	Q36159	other
[CLS] why do people think [MASK] is better than kobe bryant ? [SEP]	Kevin Durant	Q29545	better
[CLS] who is a better nba player [MASK] or kobe bryant ? [SEP]	kevin garnet	Q189240	better
[CLS] who would be a better fit for the dallas mavericks this off - season , [MASK] or dwight howard ? [SEP]	Deron Williams	Q298496	athletic
[CLS] who ' s faster [MASK] or allen iv ##erson ? 10 points ! ! ! ! ! ! ? [SEP]	Derrick Rose	Q205326	athletic
[CLS] dwight howard vs [MASK] who ' s better ? [SEP]	Shaquille O'Neal	Q169452	better
[CLS] who is more important to their team , [MASK] or cha ##unce ##y bill ##ups ? [SEP]	Derrick Rose	Q205326	importance
[CLS] who is better for the lakers ? c ##j miles or [MASK] [SEP]	cj miles	Q1022508	better
[CLS] why [MASK] fans strongly wants their king to be greater then kobe ? [SEP]	Lebron	Q36159	other
[CLS] [MASK] or kobe bryant , who accomplished more at age 28 ? [SEP]	Michael Jordan	Q41421	other
[CLS] kobe or [MASK] . . who makes more difficult shots . . . q # 2 ##w ##ho makes more in your face shots ? [SEP]	Jordan	Q41421	other
[CLS] who has a better mid - range game ? kobe or [MASK] [SEP]	paul pierce	Q121647	other
[CLS] who has a better shooting form [MASK] or kobe bryant ? [SEP]	Kevin Durant	Q29545	shooting
[CLS] who ' s better , [MASK] or z ##yd ##runa ##s il ##gau ##ska ##s while in his prime ? [SEP]	Pau Gasol	Q193052	better
[CLS] who could jump more in their prime ? kobe or [MASK] [SEP]	T-Mac	Q202295	other
[CLS] how come no one is giving kobe more credit on his 4th championship than [MASK] s ? [SEP]	Shaq	Q169452	other
[CLS] who do you think will have a better season next year ? [MASK] or greg monroe ? [SEP]	Roy Hibbert	Q738690	season
[CLS] kobe ' s the better scorer , but [MASK] is the better all around player ? [SEP]	lebron	Q36159	shooting
[CLS] is le ##bron james richer than ko ##y ##be [MASK] [SEP]	Bryant	Q25369	money
[CLS] who ' s the better scorer - kevin duran ##t or [MASK] [SEP]	Carmelo Anthony	Q129041	shooting
[CLS] who ' s a bigger ball - hog , kobe bryant or [MASK] [SEP]	Steve Nash	Q192955	other
[CLS] who is better at scoring ? [MASK] or dem ##ar der ##oza ##n ? [SEP]	Damian Lillard	Q622308	better
[CLS] who is stronger [MASK] or derrick rose ? [SEP]	eric Gordon	Q360993	strength
[CLS] who is more clutch , kobe or [MASK] [SEP]	LeBron	Q36159	clutch
[CLS] who ' s a better shooter [MASK] or ky ##rie irving ? [SEP]	Damian Lillard	Q622308	shooting
[CLS] who ' s the better player : kobe bryant or [MASK] [SEP]	Kevin Durant	Q29545	better
[CLS] tell me why [MASK] is better than kobe ? [SEP]	Lebron	Q36159	better
[CLS] who better [MASK] or paul pierce ? [SEP]	lebron	Q36159	better
[CLS] bigger nba bust : sebastian tel ##fa ##ir or [MASK] [SEP]	Josh Childress	Q357096	strength
[CLS] kobe vs [MASK] showdown game , who is really the better player ? [SEP]	Lebron	Q36159	better
[CLS] whose a better overall shooter kevin duran ##t or [MASK] [SEP]	Stephen Curry	Q352159	shooting
[CLS] who ' s better : dwight howard or [MASK] [SEP]	Alonzo Mourning	Q310968	better
[CLS] is it just me but why does [MASK] look taller than steven nash ? [SEP]	devin harris	Q358102	height
[CLS] currently , who is a better nba player , [MASK] or kobe bryant ( details pl ##z ) ? [SEP]	LeBron James	Q36159	better
[CLS] who is better dun ##ker ? [MASK] or le ##bron james . ? [SEP]	Dwight Howard	Q25278	dunking
[CLS] this year , who ##s the better shooting guard . . kobe or [MASK] [SEP]	lebron	Q36159	shooting
[CLS] why does [MASK] have more career 3 pointer ##s then kobe have career assist ? [SEP]	Shaq	Q169452	other
[CLS] who is more dominant in the post , prime sha ##q or [MASK] [SEP]	Shaq	Q169452	importance
[CLS] who is a better player when it counts ? [MASK] or steve nash ? [SEP]	Lebron James	Q36159	better
[CLS] do you think the lakers will be a better team if kobe switches place with [MASK] lb ##j fans please read detail ! ? [SEP]	LeBron	Q36159	other
[CLS] who ##s better [MASK] or ari ##za ? [SEP]	Artest	Q295322	better
[CLS] who had a better career ; [MASK] or karl malone ? [SEP]	Robert Horry	Q364394	career
[CLS] who has the better afro ? kobe bryant or [MASK] [SEP]	Andrew Bynum	Q314822	other
[CLS] who ##s a better dun ##ker . . . . le ##bron james or [MASK] [SEP]	Andre Iguodala	Q136816	dunking
[CLS] who is more clutch : kobe bryant or [MASK] [SEP]	LeBron James	Q36159	clutch
[CLS] how come people think [MASK] is better than kobe ? ? l ##j is a forward while kobe is guard . . . ? [SEP]	Lebron	Q36159	better
[CLS] is it more important for cavalier band ##wa ##gon to prove le ##bron is better than [MASK] . . . . ? [SEP]	Kobe	Q25369	importance
[CLS] who ' s stronger le ##bron or [MASK] [SEP]	ron artest	Q295322	strength
[CLS] who is more dominant [MASK] or wil ##t chamberlain ? [SEP]	Shaq	Q169452	importance
[CLS] who ' s a better dun ##ker , [MASK] or blake griffin ? [SEP]	Vince Carter	Q241261	dunking
[CLS] who is a better player kobe or [MASK] [SEP]	Lebron	Q36159	better
[CLS] why has kobe lost more nba finals games than [MASK] [SEP]	Steve Nash	Q192955	other
[CLS] who better [MASK] or paul pierce ? [SEP]	lebron james	Q36159	better
[CLS] which player would be a better fit for the ma ##vs , andrei [MASK] or gerald wallace ? [SEP]	Iguodala	Q136816	athletic
[CLS] what ' s fun ##nier charles bark ##ley ' s golf swing or [MASK] free throws ? [SEP]	Chuck Hayes	Q519298	other
[CLS] who ' s better , [MASK] or bill russell ? [SEP]	Ben Wallace	Q295364	better
[CLS] who do you think is better [MASK] or kobe bryant ? [SEP]	Lebron James	Q36159	better
[CLS] how does the orlando - la series prove that kobe is better than [MASK] [SEP]	Lebron	Q36159	better
[CLS] i need to shut this guy up at work ! ! ! he ' s saying kobe bryant is better the [MASK] ? [SEP]	LeBron James	Q36159	better
[CLS] who is really better ? [MASK] or russell ? [SEP]	Jordan	Q41421	better
[CLS] who is faster : [MASK] or raj ##on ron ##do ? [SEP]	Rajon Rondo	Q274469	athletic
[CLS] who has higher basketball iq [MASK] or kobe ? [SEP]	lebron	Q36159	other
[CLS] who is quicker , raj ##on ron ##do or [MASK] [SEP]	Devin Harris	Q358102	athletic
[CLS] who is a better player des ##haw ##n steve ##son or [MASK] [SEP]	LeBron James	Q36159	better
[CLS] harder work et ##hic : kobe or [MASK] [SEP]	lebron	Q36159	other
[CLS] y do people keep saying [MASK] is better than kobe ? [SEP]	lebron	Q36159	better
[CLS] if kobe wins 2 more rings . how [MASK] & magic are going to feel about it ? [SEP]	JORDAN	Q41421	other
[CLS] who is more valuable to his team : kobe or [MASK] [SEP]	Lebron	Q36159	other
[CLS] for kobe fans : do you at ##lea ##st agree that [MASK] is better than kobe bryant period ? [SEP]	Lebron James	Q36159	better
[CLS] luke walton has more rings than [MASK] [SEP]	lebron	Q36159	shooting
[CLS] who was the bigger bust : [MASK] or le ##bron james ? [SEP]	Kwame Brown	Q317037	strength
[CLS] who would be a better fit for the lakers ? [MASK] ? or chris paul ? [SEP]	Deron Williams	Q298496	athletic
[CLS] who is a better player kobe bryant or [MASK] [SEP]	John Stockton	Q213346	better
[CLS] prime kobe , or prime [MASK] who ##s better ? [SEP]	Iverson	Q190094	better
